2384000.0,5.0,2.5,3650,9050,2.0,3370,280,1921
490000.0,2.0,1.0,880,6380,1.0,880,0,1938
640000.0,4.0,2.0,1520,6200,1.5,1520,0,1945
1400000.0,4.0,2.5,2920,4000,1.5,1910,1010,1909
365000.0,3.0,1.0,1090,6435,1.0,1090,0,1955
1200000.0,5.0,2.75,2910,9480,1.5,2910,0,1939
750000.0,3.0,1.75,2240,10578,2.0,1550,690,1923
626000.0,3.0,2.25,1750,1572,2.5,1470,280,2005
495000.0,4.0,1.75,1600,6380,1.0,1130,470,1959
615000.0,3.0,1.75,2360,7291,1.0,1360,1000,1948
790000.0,3.0,2.5,2600,4750,1.0,1700,900,1951
650000.0,4.0,2.0,1820,5000,1.5,1640,180,1945
440000.0,2.0,1.0,800,4850,1.0,800,0,1944
750000.0,3.0,2.5,2390,6550,1.0,1440,950,1955
439950.0,3.0,2.5,1770,2875,2.0,1770,0,1990
235000.0,2.0,1.0,1210,9400,1.0,1210,0,1949
445700.0,3.0,2.5,1270,1180,3.0,1270,0,2001
805000.0,3.0,2.0,2710,4500,1.5,1880,830,1929
385000.0,3.0,3.25,1320,1327,2.0,1040,280,2008
295000.0,2.0,2.5,1630,1368,2.0,1280,350,2009
553000.0,2.0,1.0,900,5000,1.0,900,0,1944
783500.0,3.0,2.5,2850,7130,2.0,1990,860,1980
628000.0,4.0,2.0,2280,6010,1.0,1140,1140,1900
531000.0,2.0,3.0,1270,1175,2.0,1110,160,2000
831000.0,4.0,3.0,2170,4000,2.0,1610,560,1982
580000.0,2.0,1.0,2540,7000,1.0,1320,1220,1942
549000.0,2.0,1.0,1140,5400,1.0,1140,0,1908
405000.0,2.0,3.0,1410,1240,2.0,1140,270,2006
650000.0,3.0,1.5,2160,9000,1.0,1400,760,1949
823000.0,6.0,1.75,2920,5000,2.5,2780,140,1908
770000.0,3.0,2.0,2350,5700,1.5,1810,540,1939
524000.0,3.0,1.75,1560,5520,1.0,780,780,1944
670000.0,3.0,2.5,1680,2000,3.0,1680,0,1909
406100.0,3.0,2.25,1410,1332,3.0,1410,0,2005
1395000.0,5.0,3.5,4010,8510,2.0,2850,1160,1971
435000.0,5.0,2.0,1840,9240,1.0,1540,300,1942
400000.0,2.0,1.0,840,5510,1.0,840,0,1955
657100.0,4.0,1.0,1390,4240,1.0,1050,340,1924
740000.0,4.0,1.75,2010,3600,1.5,2010,0,1902
398750.0,3.0,2.5,2230,4000,2.0,2230,0,1954
287000.0,3.0,1.0,1450,6000,1.0,1450,0,1953
600000.0,3.0,1.75,1880,6360,1.0,1040,840,1945
418000.0,3.0,2.0,1410,6030,1.5,1410,0,1930
449250.0,4.0,2.0,1480,3844,1.5,1480,0,1928
329950.0,2.0,1.0,1140,5250,1.5,1140,0,1949
1425000.0,2.0,2.5,2220,4000,2.0,2220,0,2000
585000.0,2.0,1.0,1770,8640,1.5,1520,250,1949
618500.0,3.0,2.0,1800,5000,1.0,1080,720,1942
631625.0,4.0,2.5,2440,6651,2.0,2440,0,2014
340000.0,2.0,1.5,1160,1438,2.0,1160,0,2001
366750.0,3.0,3.0,1571,2017,3.0,1571,0,2008
416286.0,3.0,2.5,1408,989,3.0,1408,0,2005
450000.0,2.0,2.0,1100,3000,1.5,1100,0,1912
353000.0,3.0,1.0,1350,7740,1.0,860,490,1947
561000.0,3.0,2.0,2000,7000,2.0,2000,0,1916
469000.0,2.0,1.0,1030,4400,1.0,1030,0,1924
329350.0,2.0,1.0,720,6687,1.0,720,0,1942
488000.0,5.0,2.0,2020,5000,1.5,2020,0,1938
312000.0,4.0,2.0,1300,7054,1.0,1300,0,1950
650000.0,3.0,1.5,1630,7475,1.0,1160,470,1940
1135000.0,4.0,2.75,3370,8103,1.0,1970,1400,1970
325000.0,4.0,2.5,1890,6156,1.0,980,910,1980
219000.0,2.0,1.0,900,5160,1.0,900,0,1952
460000.0,2.0,2.25,1230,929,2.0,1020,210,2004
612500.0,4.0,2.0,2060,5000,1.0,1030,1030,1949
313950.0,3.0,1.0,1510,6083,1.0,860,650,1940
575000.0,3.0,1.75,2130,6500,1.0,1170,960,1954
1225000.0,4.0,2.25,3490,6906,2.0,2280,1210,1928
365000.0,3.0,1.5,1310,8160,1.0,1310,0,1950
1580000.0,4.0,3.25,3760,10920,1.5,2400,1360,1950
484000.0,2.0,1.75,1660,6000,1.0,1160,500,1942
345000.0,3.0,1.0,1110,6250,1.0,1110,0,1956
533000.0,5.0,2.75,1800,3780,1.5,1400,400,1926
385000.0,3.0,1.75,1900,5520,1.0,1280,620,1982
485000.0,3.0,2.0,1420,4080,1.5,1420,0,1905
499000.0,2.0,1.75,1170,2400,1.0,740,430,1903
1050000.0,3.0,2.5,2200,1970,2.0,1610,590,2008
500000.0,3.0,2.5,1480,1171,3.0,1480,0,2006
390000.0,5.0,3.75,2890,5000,1.0,1310,1580,2006
979000.0,3.0,2.5,2690,4047,3.0,2690,0,2014
369950.0,3.0,2.0,1270,1320,3.0,1270,0,2006
519950.0,3.0,2.25,1170,1249,3.0,1170,0,2014
495000.0,3.0,1.0,990,6000,1.0,990,0,1943
750000.0,3.0,2.75,2520,5401,1.0,1360,1160,1946
599999.0,9.0,4.5,3830,6988,2.5,2450,1380,1938
526000.0,2.0,2.0,1550,2400,1.5,1550,0,1900
3200000.0,7.0,4.5,6210,8856,2.5,4760,1450,1910
420000.0,2.0,1.5,1040,3500,1.5,1040,0,1904
749950.0,4.0,2.75,2600,6050,2.0,1960,640,1949
568000.0,3.0,2.0,2350,5080,1.5,1780,570,1929
500000.0,2.0,1.0,1010,3885,1.5,1010,0,1906
475000.0,2.0,1.0,820,2723,1.0,820,0,1921
352000.0,5.0,2.5,2420,8560,1.0,1620,800,1978
599000.0,3.0,1.75,1960,4788,1.0,1090,870,1920
575000.0,4.0,2.0,1650,5000,1.0,1650,0,1955
705000.0,4.0,2.5,2650,4316,1.5,1520,1130,1905
940000.0,4.0,2.25,1890,5940,1.0,1470,420,1963
485000.0,3.0,2.0,1610,4160,1.0,1010,600,1917
300000.0,2.0,1.0,760,3001,1.0,760,0,1913
1500000.0,6.0,2.5,3560,6480,2.5,3560,0,1914
1340000.0,3.0,3.0,2960,5500,2.0,2440,520,1937
361280.0,2.0,1.0,820,6400,1.0,820,0,1944
440000.0,3.0,1.75,1500,6180,1.0,1060,440,1947
530000.0,3.0,1.0,1340,4284,1.0,1080,260,1910
775000.0,3.0,2.0,2540,7200,1.5,1600,940,1905
380000.0,5.0,1.75,3000,6000,1.0,1500,1500,1958
690000.0,3.0,2.0,1760,6428,1.0,980,780,1942
794154.0,4.0,2.0,2210,8556,1.0,1210,1000,1954
245000.0,3.0,1.5,1260,1270,2.0,1040,220,2005
425000.0,2.0,2.5,1150,1027,3.0,1150,0,2008
365000.0,5.0,2.75,2410,5003,1.0,1410,1000,2008
417250.0,3.0,2.25,1606,1452,3.0,1606,0,2009
339950.0,2.0,1.0,820,681,3.0,820,0,2006
615000.0,2.0,1.0,1540,6872,1.0,820,720,1946
533000.0,3.0,1.0,1670,4080,1.0,1170,500,1967
712000.0,3.0,1.0,1250,4620,1.5,1150,100,1900
205000.0,2.0,1.0,720,5040,1.0,720,0,1955
553650.0,2.0,2.5,1360,1349,2.0,1050,310,1997
719000.0,3.0,2.5,1690,4500,1.5,1690,0,1928
1039000.0,4.0,1.0,3410,5000,2.0,2190,1220,1910
515000.0,2.0,1.0,1060,4960,1.0,1060,0,1926
207000.0,3.0,1.0,1490,8995,1.0,1490,0,1954
385000.0,3.0,1.75,1890,9920,1.0,1230,660,1944
235000.0,2.0,1.0,1270,3008,1.0,650,620,1923
358000.0,2.0,1.5,960,1808,2.0,960,0,1993
228000.0,4.0,1.75,2000,6120,1.0,1100,900,1965
405000.0,2.0,1.0,1020,8155,1.0,1020,0,1948
1750000.0,6.0,3.0,3510,5760,2.5,3510,0,1906
636000.0,2.0,1.75,1230,3600,1.5,1230,0,1925
530000.0,4.0,2.75,2280,2850,1.5,1540,740,1930
230000.0,3.0,1.75,950,6000,1.0,790,160,1939
1307000.0,5.0,3.25,2800,3200,1.5,1910,890,1932
660000.0,3.0,1.75,1320,5750,1.5,1320,0,1918
413450.0,3.0,2.5,1540,1614,3.0,1470,70,2008
930000.0,3.0,3.25,2640,4080,2.0,1840,800,1912
835000.0,4.0,2.0,1910,6960,1.5,1910,0,1941
500000.0,3.0,1.75,1410,1197,3.0,1410,0,2012
499000.0,2.0,1.5,1110,957,2.0,930,180,2005
321950.0,2.0,1.25,860,1277,2.0,860,0,2007
441750.0,2.0,1.5,1020,1060,3.0,1020,0,2008
438000.0,2.0,1.0,980,1179,2.0,980,0,2010
460000.0,4.0,1.75,1750,5500,1.5,1050,700,1926
255000.0,2.0,1.0,810,7980,1.0,810,0,1928
445000.0,4.0,2.0,1650,6000,1.0,1000,650,1959
195000.0,2.0,1.0,720,18000,1.0,720,0,1950
490000.0,2.0,1.0,1840,3300,1.5,1130,710,1910
270000.0,3.0,1.5,1500,6337,1.0,1500,0,1953
382000.0,3.0,3.25,1410,1253,3.0,1410,0,2005
536500.0,4.0,1.75,2000,4000,1.5,1450,550,1926
463000.0,2.0,1.0,1150,4400,1.0,1150,0,1905
742500.0,4.0,2.75,3100,3773,2.0,2000,1100,1919
325000.0,3.0,2.25,1352,1694,3.0,1352,0,2007
481450.0,3.0,2.0,1410,4800,1.0,1410,0,1940
252500.0,3.0,1.0,1030,6127,1.0,880,150,1947
536000.0,3.0,1.75,1300,5413,1.5,1300,0,1925
445000.0,2.0,2.0,1150,6634,1.0,860,290,1940
769900.0,4.0,3.5,2730,3047,2.0,2400,330,2006
212000.0,2.0,1.5,1020,1525,2.0,1020,0,2004
376000.0,3.0,2.0,1340,1384,3.0,1340,0,2008
324000.0,3.0,2.25,998,904,2.0,798,200,2007
549900.0,5.0,2.75,3060,7015,1.0,1600,1460,1979
875000.0,4.0,2.0,2520,6000,1.0,1400,1120,1921
394950.0,3.0,2.5,1350,1250,3.0,1270,80,2006
842500.0,4.0,2.5,2160,5298,2.5,2160,0,1902
368000.0,3.0,2.5,1370,1350,2.0,1010,360,2007
885000.0,4.0,2.5,2830,5000,2.0,2830,0,1995
490000.0,2.0,2.5,1230,1391,2.0,870,360,2004
235000.0,1.0,1.0,810,2451,1.0,810,0,1941
255000.0,2.0,1.0,1220,2500,1.0,770,450,1910
350000.0,2.0,1.0,910,4500,1.5,910,0,1906
582000.0,4.0,1.75,2120,4650,1.0,1190,930,1951
1315000.0,4.0,3.5,3460,3997,2.0,2560,900,2004
372500.0,5.0,3.0,2480,10090,1.0,1300,1180,2004
360000.0,4.0,2.0,1730,5500,1.0,1010,720,1943
1015000.0,3.0,2.5,2920,34527,1.0,1800,1120,1954
210000.0,3.0,2.5,1040,2643,2.0,720,320,2004
770000.0,3.0,1.75,1720,5000,1.0,1720,0,1954
499950.0,3.0,1.0,980,6380,1.0,760,220,1941
500000.0,2.0,2.25,1290,1334,3.0,1290,0,2007
870300.0,4.0,2.5,2350,3150,1.5,1690,660,1910
315275.0,3.0,1.75,1440,8040,1.0,960,480,1951
505000.0,4.0,1.75,1940,4800,1.0,1030,910,1922
610000.0,4.0,3.0,2110,5000,1.5,1640,470,1930
910000.0,3.0,2.0,2700,6120,1.0,1350,1350,1962
1300000.0,4.0,3.25,2330,9687,2.0,2330,0,1918
840000.0,4.0,2.75,2600,2750,1.5,1620,980,1936
300000.0,2.0,1.75,1360,8100,1.0,860,500,1975
675000.0,4.0,3.0,2400,3340,1.0,1200,1200,1964
734200.0,4.0,2.5,2760,5000,1.5,1680,1080,1928
630000.0,4.0,2.0,1770,6000,2.0,1770,0,1911
301500.0,2.0,1.5,830,1333,2.0,830,0,2005
369000.0,2.0,2.5,980,895,2.0,670,310,2009
635000.0,3.0,2.5,1570,1433,3.0,1570,0,2010
625000.0,3.0,3.5,1810,1846,2.0,1440,370,2009
525000.0,5.0,3.0,2450,4591,2.0,2450,0,1994
628000.0,4.0,2.0,2260,6000,1.0,1430,830,1958
245000.0,5.0,1.75,2020,7902,1.0,1220,800,1962
415000.0,3.0,1.75,1960,5000,1.0,980,980,1911
799200.0,6.0,3.0,2890,2370,2.5,2290,600,1906
591000.0,3.0,1.75,1680,2400,1.0,870,810,1922
575000.0,3.0,1.75,1580,11750,1.0,1180,400,1951
771000.0,3.0,2.25,1780,6120,1.5,1390,390,1927
155000.0,2.0,1.0,910,6232,1.0,910,0,1943
550000.0,7.0,4.0,3440,8100,2.0,3440,0,1970
2555000.0,4.0,2.5,5300,26211,2.0,4570,730,1923
717000.0,3.0,1.5,1310,3880,1.0,1090,220,1956
225000.0,3.0,1.0,1040,6535,1.0,1040,0,1947
230000.0,2.0,0.75,650,5360,1.0,650,0,1931
385000.0,3.0,2.0,1480,6600,1.0,740,740,1943
665000.0,3.0,2.0,1940,5820,1.5,1150,790,1944
620000.0,3.0,1.0,1710,4050,1.5,1710,0,1909
1105000.0,4.0,1.5,2740,4000,2.0,1930,810,1905
450000.0,3.0,2.75,1250,892,2.0,1040,210,2010
560000.0,3.0,1.0,1440,5000,2.0,1440,0,1910
413000.0,4.0,1.0,1410,6000,1.0,810,600,1925
570000.0,3.0,2.0,1530,5401,1.0,1530,0,1937
465000.0,3.0,1.5,1270,5112,1.0,1270,0,1950
525000.0,3.0,2.5,1580,1161,2.0,1010,570,2008
870000.0,4.0,2.5,3520,6773,2.5,2650,870,2006
650000.0,4.0,2.5,2210,4861,2.0,2210,0,2013
330000.0,3.0,2.5,1450,5008,1.0,840,610,2007
385000.0,4.0,1.75,1620,4980,1.0,860,760,1947
306000.0,3.0,1.5,1220,1086,3.0,1220,0,2007
546000.0,3.0,1.75,2000,5000,1.0,1110,890,1921
800000.0,3.0,1.0,1700,4400,1.5,1700,0,1906
620000.0,5.0,2.5,2540,3832,2.0,1760,780,1929
372220.0,3.0,1.0,1290,5500,1.0,980,310,1951
337500.0,5.0,2.0,1700,7314,1.0,1000,700,1956
582500.0,2.0,1.5,1159,4800,1.0,1159,0,1948
405100.0,2.0,1.0,840,3522,1.0,840,0,1947
538000.0,3.0,1.75,1400,3825,1.5,1100,300,1904
1400000.0,3.0,2.5,2550,7200,2.0,2550,0,1981
702500.0,3.0,1.5,2360,6750,2.0,1930,430,1926
682000.0,3.0,1.75,1830,5120,1.5,1830,0,1903
525000.0,3.0,1.75,1600,6120,1.5,1600,0,1924
394475.0,2.0,1.0,830,4000,1.0,830,0,1955
339950.0,3.0,1.0,1050,5402,1.5,1050,0,1906
715000.0,4.0,2.25,2060,5649,1.0,1360,700,1941
458000.0,3.0,1.0,1660,7500,1.0,1060,600,1940
607500.0,5.0,1.75,2220,6000,1.5,1420,800,1923
400000.0,2.0,1.0,980,2130,1.0,860,120,1918
300000.0,3.0,1.0,1260,8280,1.0,1260,0,1946
185000.0,3.0,1.0,1150,8100,1.0,1150,0,1932
451555.0,2.0,1.0,1320,4520,1.0,1320,0,1912
840000.0,4.0,1.75,2930,11562,1.0,1670,1260,1947
349950.0,3.0,1.0,1400,7066,1.0,1400,0,1957
613000.0,4.0,2.0,1550,4815,1.5,1550,0,1909
197500.0,3.0,1.0,980,3090,1.5,980,0,1903
1255000.0,4.0,2.5,3200,7535,2.0,3200,0,2006
575000.0,2.0,1.0,1490,6000,1.0,1090,400,1946
585000.0,5.0,1.75,2000,3750,2.0,2000,0,1921
475000.0,7.0,3.5,2870,29699,1.0,1520,1350,1961
790000.0,3.0,1.75,1790,6117,1.0,1350,440,1940
744000.0,4.0,3.0,1980,5352,2.5,1980,0,1941
312500.0,2.0,1.0,880,6345,1.0,880,0,1919
495000.0,4.0,2.0,2050,4000,1.5,1210,840,1941
580050.0,3.0,2.5,2360,4638,2.0,2360,0,1996
640000.0,4.0,2.0,2560,7798,1.0,1890,670,1947
295000.0,3.0,1.5,850,2500,1.0,850,0,1986
343000.0,4.0,1.75,2290,10290,1.0,1340,950,1960
467000.0,3.0,1.0,1660,6582,1.0,1000,660,1946
512500.0,3.0,2.5,1840,2875,2.0,1840,0,1997
465000.0,3.0,1.75,1410,6886,1.0,1410,0,1924
340000.0,3.0,1.75,1960,8136,1.0,980,980,1948
497000.0,4.0,2.5,2240,7200,2.0,2240,0,1995
344000.0,3.0,2.5,1232,1130,3.0,1232,0,2007
312000.0,3.0,2.25,1490,974,2.0,1220,270,2009
350000.0,1.0,1.0,700,5100,1.0,700,0,1942
408200.0,3.0,2.5,1800,5761,2.0,1800,0,1990
451000.0,3.0,1.75,1560,4049,1.5,1000,560,1926
799000.0,4.0,3.25,3120,5000,2.0,2370,750,2005
720000.0,2.0,1.0,2020,7200,1.0,1700,320,1947
490000.0,3.0,2.0,1450,2400,1.5,1450,0,1900
342000.0,3.0,1.0,1260,6826,1.0,720,540,1944
724800.0,3.0,2.0,2050,3933,1.0,1180,870,1926
605000.0,2.0,1.0,910,3600,1.0,910,0,1909
785000.0,3.0,2.0,2180,5440,1.0,1100,1080,1904
565000.0,3.0,2.25,1520,1221,3.0,1520,0,2013
875000.0,3.0,2.0,2220,6641,1.0,1220,1000,1947
620000.0,3.0,2.25,1720,4000,1.5,1450,270,1921
245000.0,2.0,1.0,870,6150,1.0,870,0,1941
238000.0,3.0,2.0,1020,1204,2.0,720,300,2004
523000.0,3.0,1.5,1260,3135,1.5,1260,0,1931
180000.0,3.0,1.0,1000,18513,1.0,1000,0,1940
375000.0,3.0,1.5,1100,1751,2.0,940,160,2007
540000.0,1.0,1.0,1140,6700,1.5,1140,0,1920
605000.0,3.0,2.25,1290,2500,2.0,1290,0,1987
490000.0,2.0,1.0,1160,5000,1.0,1160,0,1937
341000.0,3.0,2.5,1480,1663,2.0,1180,300,2012
500000.0,2.0,2.5,1310,1500,2.0,1160,150,2006
410000.0,3.0,2.0,1700,4250,1.0,890,810,1944
488000.0,2.0,2.0,1360,4688,1.0,780,580,1944
592500.0,2.0,2.0,1420,9191,1.5,1420,0,1928
475000.0,2.0,1.0,1490,3825,1.0,860,630,1929
487250.0,4.0,2.0,1690,3250,1.5,1550,140,1901
440000.0,2.0,1.5,1010,1968,1.5,1010,0,1906
462000.0,3.0,1.5,1710,4500,1.5,1410,300,1928
560000.0,4.0,1.0,1660,4690,1.5,1260,400,1945
285000.0,4.0,1.75,2080,13629,1.0,1040,1040,1955
210000.0,3.0,1.0,1080,21043,1.0,1080,0,1942
690000.0,3.0,2.0,1610,5100,1.5,1610,0,1940
411000.0,4.0,2.75,2500,5257,2.0,2500,0,1966
762000.0,5.0,2.0,3370,5000,1.5,2140,1230,1907
413500.0,2.0,1.0,770,4000,1.0,770,0,1924
524950.0,3.0,1.75,1890,3825,1.0,1290,600,1974
461000.0,2.0,1.0,1060,7193,1.0,1060,0,1926
885000.0,4.0,2.75,2730,3560,1.5,1550,1180,1921
333000.0,4.0,2.0,1580,7800,2.0,1580,0,1906
485000.0,3.0,1.0,1500,4100,1.5,1370,130,1926
482500.0,3.0,2.25,1450,1445,2.0,980,470,2005
485000.0,2.0,2.25,1260,1240,3.0,1260,0,2004
850000.0,4.0,3.5,2640,5900,2.0,2640,0,1937
700000.0,3.0,1.75,2010,4905,1.0,1230,780,1912
368000.0,2.0,1.5,1660,4680,1.0,830,830,1908
433500.0,3.0,2.5,2200,3360,2.0,2200,0,2009
367000.0,2.0,1.0,700,2334,1.0,700,0,1945
477000.0,3.0,2.5,1350,2053,3.0,1350,0,2005
518000.0,3.0,2.5,1680,2096,2.0,1380,300,2008
1190000.0,4.0,3.0,2240,6000,1.5,1270,970,1914
137000.0,3.0,1.0,950,7620,1.0,950,0,1954
640000.0,2.0,2.25,1540,958,3.0,1540,0,2007
271310.0,2.0,1.0,870,5340,1.5,870,0,1906
479000.0,3.0,2.5,1260,889,3.0,1260,0,2008
520000.0,4.0,3.5,2680,10000,2.0,2040,640,1942
599950.0,3.0,2.5,2660,4975,2.0,2660,0,2014
483945.0,2.0,1.75,1480,5120,1.0,840,640,1951
192500.0,2.0,1.0,950,7692,1.0,950,0,1926
330000.0,2.0,1.0,860,8308,1.0,860,0,1948
243000.0,2.0,1.0,1770,5522,1.5,960,810,1943
575000.0,4.0,1.75,1280,6060,1.0,860,420,1926
710000.0,2.0,1.0,1790,4000,1.0,1040,750,1923
490000.0,3.0,1.0,1910,8190,1.0,1010,900,1946
467000.0,3.0,2.25,1270,1213,2.0,1040,230,2005
480000.0,4.0,2.75,2050,3960,1.0,1180,870,1986
755000.0,6.0,2.0,2150,4505,1.0,1270,880,1952
387000.0,2.0,2.25,1230,1280,2.0,960,270,2012
570000.0,2.0,1.75,1540,4025,1.0,1190,350,1908
387500.0,4.0,1.0,1320,4440,1.5,1320,0,1929
396675.0,2.0,1.0,1730,6375,2.0,1730,0,1945
452000.0,4.0,1.0,1210,3760,1.5,1210,0,1900
792000.0,3.0,1.5,1570,1050,2.0,1570,0,1915
1275000.0,4.0,2.0,2850,7861,1.0,1450,1400,1970
440000.0,2.0,1.75,1300,4000,2.0,1300,0,1948
525000.0,3.0,1.5,1540,4773,2.0,1540,0,1941
978000.0,4.0,2.75,2620,13777,1.5,1720,900,1926
1125000.0,6.0,3.0,2880,3192,2.0,2180,700,1919
700000.0,4.0,1.0,1680,4021,1.5,1680,0,1921
309000.0,3.0,1.0,1092,7500,1.5,1092,0,1918
699000.0,4.0,2.5,2650,7945,2.0,2650,0,2006
1100000.0,3.0,2.0,2390,6888,2.0,2390,0,1939
430000.0,3.0,1.75,1200,4500,1.0,1200,0,1906
376000.0,2.0,1.0,1150,4000,1.0,1150,0,1947
475000.0,4.0,1.75,1650,7775,1.0,1150,500,1950
1690000.0,3.0,1.75,3400,8965,1.0,1820,1580,1957
619500.0,3.0,2.5,1700,4105,2.0,1700,0,1992
194000.0,1.0,1.0,820,1060,1.0,760,60,2007
329000.0,4.0,2.5,1600,6765,1.0,830,770,1947
494000.0,4.0,1.75,2090,4300,1.5,1250,840,1925
423000.0,4.0,1.75,1940,6909,1.0,970,970,1941
879950.0,4.0,2.25,3500,13875,1.0,1830,1670,1938
345600.0,5.0,3.5,2800,5120,2.5,2800,0,1903
395000.0,3.0,1.5,1080,2940,1.5,1080,0,1920
380000.0,3.0,1.75,1690,1468,2.0,1380,310,2008
440000.0,3.0,1.5,1270,1443,3.0,1270,0,2007
415000.0,3.0,2.25,1970,2377,2.0,1680,290,2008
500000.0,3.0,2.5,1210,1200,3.0,1210,0,2008
953007.0,4.0,3.5,3120,5086,2.0,2480,640,2008
772000.0,3.0,2.25,1640,1204,3.0,1640,0,2014
490000.0,5.0,3.5,4460,2975,3.0,3280,1180,2013
305000.0,2.0,2.5,1590,2656,2.0,1220,370,2009
325000.0,3.0,1.0,990,6750,1.0,990,0,1947
720000.0,3.0,2.5,2020,1159,3.0,2020,0,2000
199000.0,4.0,2.0,2030,8120,2.0,2030,0,1950
1506000.0,4.0,3.25,3660,5800,2.5,3360,300,1909
635000.0,4.0,2.25,2750,6180,1.0,1500,1250,1948
210000.0,3.0,1.0,1240,4842,1.0,1240,0,1916
475000.0,4.0,2.0,1790,2250,1.0,840,950,1909
230000.0,5.0,2.0,1930,6120,1.5,1930,0,1941
249900.0,2.0,1.0,1140,5500,1.0,1140,0,1947
270000.0,3.0,1.75,1390,10905,1.0,860,530,1957
495000.0,3.0,3.5,2380,6250,2.0,1670,710,1997
1003000.0,4.0,2.75,2290,6120,2.0,2170,120,1926
299800.0,2.0,1.0,790,5240,1.0,790,0,1925
360000.0,2.0,0.75,850,7710,1.0,550,300,1909
218000.0,3.0,1.0,1020,7874,1.0,1020,0,1956
452000.0,4.0,2.0,1660,6150,1.0,850,810,1945
246000.0,3.0,1.5,1780,23819,1.0,1780,0,1953
535000.0,2.0,1.0,1030,4841,1.0,920,110,1939
430000.0,3.0,1.0,1150,3000,1.0,1150,0,1906
450000.0,2.0,1.0,1200,4000,1.0,1070,130,1940
525000.0,3.0,1.0,1450,4000,1.0,950,500,1948
1220000.0,4.0,2.5,3240,3600,2.0,2060,1180,2008
540000.0,3.0,2.0,1470,1691,2.0,1000,470,2007
285000.0,3.0,1.75,2380,6000,1.5,1320,1060,1935
300000.0,2.0,1.0,970,13700,1.0,970,0,1949
700000.0,4.0,3.25,2780,7875,2.0,2780,0,2006
334990.0,4.0,2.5,2220,4228,2.0,2220,0,2014
360000.0,3.0,2.5,1530,1131,3.0,1530,0,2009
373500.0,2.0,1.0,800,3330,1.0,800,0,1918
494400.0,2.0,1.75,1560,1750,1.0,780,780,1904
926300.0,3.0,1.5,1660,4800,2.0,1660,0,1907
600000.0,3.0,1.75,1650,5100,1.0,1040,610,1908
219900.0,3.0,1.0,910,6000,1.0,910,0,1956
270000.0,2.0,1.5,840,867,2.0,840,0,2005
432000.0,3.0,2.25,1470,1578,2.0,1090,380,2007
305000.0,4.0,1.75,2200,8100,1.5,1400,800,1942
235750.0,2.0,1.0,740,11250,1.0,740,0,1938
657000.0,4.0,1.75,2740,8520,1.0,1370,1370,1954
150000.0,2.0,1.0,820,10270,1.0,820,0,1954
319950.0,2.0,1.0,1070,5824,1.0,1070,0,1949
337000.0,3.0,1.0,1070,6109,1.0,1070,0,1951
492000.0,4.0,2.0,1640,5000,2.0,1640,0,1907
400000.0,3.0,1.0,1040,6250,1.0,1040,0,1942
431500.0,3.0,3.5,1900,1612,2.0,1430,470,2008
677000.0,3.0,2.0,2000,3207,1.0,1100,900,1916
1180500.0,3.0,1.75,1610,7200,1.0,1090,520,1973
168000.0,2.0,2.5,1160,2174,2.0,1160,0,1998
805000.0,4.0,2.75,2410,6000,1.0,1410,1000,1950
940000.0,4.0,2.75,2080,4000,1.5,2080,0,1912
380000.0,2.0,2.5,1230,987,2.0,1060,170,2011
353250.0,2.0,1.0,1060,1600,2.0,1060,0,1979
320000.0,3.0,2.25,998,844,2.0,798,200,2007
321000.0,3.0,2.25,1347,1292,3.0,1347,0,2010
359000.0,3.0,1.5,1360,885,3.0,1360,0,2008
300000.0,5.0,2.5,2760,6000,2.0,2760,0,2006
380000.0,5.0,3.5,2420,4670,2.0,2420,0,2013
355000.0,3.0,2.25,1280,959,3.0,1280,0,2005
353000.0,1.0,1.0,550,1279,2.0,550,0,2008
430000.0,2.0,2.5,1520,1588,2.0,1240,280,2007
460000.0,3.0,1.0,1670,4005,1.5,1170,500,1939
325000.0,3.0,1.0,1920,6862,1.0,1120,800,1952
980000.0,4.0,3.0,3680,5854,1.0,2060,1620,1967
662990.0,3.0,1.75,1240,3600,1.5,1240,0,1926
478000.0,3.0,1.0,1280,2580,1.5,1280,0,1910
515000.0,2.0,1.0,1680,6500,1.0,1140,540,1941
149000.0,3.0,1.0,1700,8645,1.0,1700,0,1955
526000.0,3.0,1.75,1680,3420,1.0,960,720,1992
648475.0,4.0,2.75,2250,5700,1.0,1200,1050,1951
383000.0,3.0,1.0,1800,5612,1.0,1200,600,1942
449950.0,3.0,2.0,1560,4080,2.0,1560,0,1923
599000.0,3.0,2.75,1960,2500,1.5,1410,550,1926
595000.0,2.0,1.5,1030,4500,1.0,830,200,1924
1325000.0,4.0,3.0,3370,7920,1.0,1860,1510,1988
661254.0,4.0,4.0,2290,6250,1.5,1690,600,1940
641000.0,3.0,1.75,1620,3975,1.0,940,680,1926
464600.0,3.0,1.75,1120,5500,1.5,1120,0,1925
300000.0,2.0,1.0,1340,7788,1.0,1340,0,1947
670500.0,4.0,2.0,1590,6750,1.0,1590,0,1951
552000.0,3.0,1.0,1430,5000,1.0,1080,350,1919
244000.0,4.0,1.0,1450,8960,1.0,1450,0,1943
530000.0,4.0,1.75,1814,5000,1.0,944,870,1951
90000.0,2.0,1.0,580,7500,1.0,580,0,1943
585000.0,3.0,2.0,1670,4572,1.5,1670,0,1931
379000.0,2.0,1.0,800,6380,1.0,800,0,1940
462000.0,3.0,1.75,1300,2580,1.0,820,480,1919
606000.0,3.0,1.0,1500,3920,1.0,1000,500,1947
334000.0,4.0,2.5,2210,6080,1.0,1410,800,1965
360000.0,3.0,2.0,1270,1323,3.0,1270,0,2006
235000.0,2.0,1.0,1140,1730,1.5,1010,130,2007
580000.0,3.0,2.5,1620,1173,3.0,1470,150,2008
355000.0,3.0,2.0,1220,1186,3.0,1220,0,2007
375000.0,2.0,2.5,750,1430,2.0,750,0,2006
479000.0,3.0,1.0,1370,3000,1.5,1370,0,1924
501000.0,2.0,1.0,1010,4320,1.0,1010,0,1924
276000.0,3.0,1.0,1140,5000,1.0,1140,0,1960
468000.0,2.0,1.0,1160,6000,1.0,860,300,1942
477000.0,4.0,2.75,1720,6270,2.0,1720,0,1978
529000.0,3.0,1.0,1210,3328,1.5,1210,0,1924
312000.0,3.0,1.5,1255,1374,3.0,1255,0,2004
326100.0,2.0,1.0,880,7683,1.0,880,0,1942
360000.0,3.0,1.0,1050,9206,1.5,1050,0,1954
1050000.0,4.0,2.5,2920,7200,1.0,1470,1450,1921
688000.0,4.0,3.0,3000,4000,1.5,1970,1030,1913
160000.0,2.0,1.0,1180,9350,1.0,1180,0,1918
1570000.0,4.0,3.75,3070,5850,2.0,2400,670,1927
400000.0,2.0,1.0,1470,6120,1.0,1470,0,1940
730001.0,3.0,2.0,1840,4750,1.0,1010,830,1951
751750.0,2.0,2.0,1880,5400,1.5,1880,0,1902
457500.0,3.0,1.75,1840,4030,1.0,1050,790,1925
732000.0,3.0,2.5,2330,1987,2.0,1410,920,2004
1655000.0,4.0,3.5,3080,4815,2.0,2300,780,1937
535000.0,2.0,1.0,1040,5527,1.0,1040,0,1951
540000.0,4.0,4.25,1960,3565,2.0,1960,0,1940
525000.0,5.0,3.0,2750,3800,1.5,1750,1000,1926
1100000.0,3.0,2.75,2640,4050,1.5,1750,890,1926
499950.0,3.0,3.5,1820,1501,2.0,1430,390,2014
329000.0,3.0,1.0,1600,5952,1.0,1150,450,1964
435000.0,3.0,1.0,1270,4000,1.5,1270,0,1928
780000.0,3.0,3.0,2520,2152,1.5,1560,960,1925
345000.0,2.0,1.5,1180,844,2.0,990,190,2005
967500.0,3.0,3.75,3250,5797,2.0,2370,880,1951
375000.0,3.0,1.5,2000,7294,1.0,1520,480,1965
1600000.0,3.0,3.25,3790,19000,2.0,3790,0,1985
994000.0,3.0,2.25,2510,6339,1.5,1810,700,1932
675000.0,3.0,2.5,2540,7680,2.0,2540,0,1940
280000.0,3.0,1.0,1200,6250,1.0,920,280,1943
535000.0,4.0,2.5,2340,5600,2.0,2340,0,1921
427000.0,2.0,1.0,920,3780,1.0,920,0,1910
405000.0,2.0,1.0,910,6490,1.0,910,0,1942
480000.0,3.0,1.0,1150,4945,1.0,1150,0,1943
725000.0,3.0,1.5,2500,4774,1.5,1450,1050,1940
488000.0,3.0,2.5,1590,2550,3.0,1590,0,1985
460000.0,3.0,3.5,1600,1431,2.0,1240,360,2006
399950.0,3.0,3.0,1296,1051,3.0,1296,0,2009
370000.0,2.0,2.25,1280,835,2.0,1080,200,2009
495000.0,3.0,2.5,1750,1548,3.0,1750,0,2013
599000.0,4.0,2.75,2020,2750,1.0,1010,1010,1917
815000.0,4.0,2.25,2000,3800,2.0,2000,0,2001
740000.0,2.0,1.75,2080,4800,1.0,1080,1000,1923
925000.0,3.0,2.5,2690,7000,2.0,1840,850,1943
1285000.0,4.0,2.5,3240,10800,1.0,2260,980,1946
335000.0,4.0,2.0,1480,3132,1.0,740,740,1910
840000.0,4.0,2.75,3040,2800,2.0,2100,940,1906
450000.0,3.0,1.0,1100,4600,1.0,1100,0,1917
681000.0,3.0,1.0,1700,6356,1.5,1700,0,1907
370000.0,3.0,1.0,800,2296,1.0,800,0,1908
150000.0,3.0,1.0,820,7680,1.5,820,0,1910
432500.0,3.0,1.75,1980,5100,1.0,1270,710,1965
1175000.0,3.0,2.5,1970,23180,1.0,1100,870,1937
820000.0,3.0,2.5,2510,5503,2.0,2510,0,1995
1400000.0,4.0,3.25,2980,7000,2.0,2140,840,1900
438750.0,3.0,1.75,1610,6480,1.0,1610,0,1947
1210000.0,4.0,2.75,3650,6982,2.0,2530,1120,1951
589000.0,3.0,1.0,1110,6000,1.5,1110,0,1932
590000.0,3.0,2.0,1650,6150,2.0,1650,0,1926
210000.0,2.0,1.5,880,1157,2.0,880,0,2007
840500.0,3.0,2.0,2520,5400,1.5,1410,1110,1906
565000.0,7.0,4.5,4140,9066,1.0,2070,2070,1978
380000.0,3.0,2.0,1660,8281,1.0,1660,0,1949
355000.0,2.0,1.0,1270,3200,1.0,960,310,1920
277000.0,4.0,1.0,1450,6250,1.0,990,460,1964
270000.0,3.0,1.75,1300,4127,1.0,650,650,1918
700000.0,2.0,1.75,2320,5500,1.5,1720,600,1925
635000.0,3.0,2.5,2300,5500,1.5,2000,300,1921
510250.0,3.0,1.75,1400,4000,1.0,870,530,1951
960000.0,4.0,2.25,2410,4560,2.0,1800,610,1929
580000.0,5.0,2.0,1940,6000,1.0,970,970,1945
1970000.0,8.0,3.5,4440,6480,2.0,3140,1300,1959
285000.0,2.0,1.0,800,6240,1.0,800,0,1954
840000.0,4.0,1.75,2330,4000,2.0,1300,1030,1924
474800.0,2.0,3.25,1400,1243,3.0,1400,0,2000
430000.0,3.0,3.75,3890,7140,1.0,2390,1500,1943
345000.0,2.0,1.0,1080,4000,1.0,1080,0,1940
875000.0,3.0,2.75,2280,4280,1.0,1280,1000,1917
1400000.0,4.0,3.25,4700,9160,1.0,2520,2180,2005
325000.0,2.0,2.5,1050,1609,2.0,1050,0,2005
485000.0,4.0,1.0,1600,4300,1.5,1600,0,1916
535000.0,3.0,2.5,1360,1016,3.0,1310,50,2003
389000.0,2.0,1.0,910,7000,1.0,910,0,1952
400000.0,4.0,1.5,1390,7200,1.0,1140,250,1965
820000.0,4.0,2.25,2280,6660,1.5,1960,320,1940
436500.0,2.0,1.0,1260,5000,1.0,1040,220,1951
2453500.0,4.0,3.5,4730,13586,1.5,4270,460,1935
680000.0,3.0,2.25,2330,4000,1.5,1520,810,1927
750500.0,5.0,3.0,2170,2440,1.5,1450,720,1911
550000.0,5.0,2.0,2450,9488,1.0,1240,1210,1900
619000.0,4.0,2.0,2300,3400,1.5,1550,750,1915
300000.0,2.0,1.0,820,3844,1.0,820,0,1916
400000.0,4.0,2.75,1240,3867,1.0,800,440,1987
450000.0,4.0,2.0,2240,7725,1.0,1120,1120,1956
595000.0,3.0,2.0,1480,5000,1.0,750,730,1928
155000.0,3.0,1.0,1250,6250,1.0,1030,220,1949
529000.0,3.0,1.0,1590,6420,1.0,1590,0,1944
635200.0,4.0,1.75,1640,4240,1.0,920,720,1921
540000.0,3.0,1.5,2600,5085,1.0,1400,1200,1940
402000.0,2.0,1.0,710,1173,2.0,710,0,1943
329932.0,3.0,1.5,1460,5040,1.0,1100,360,1971
445000.0,4.0,1.75,1990,4725,1.5,1190,800,1944
395000.0,2.0,1.0,1320,1824,1.5,1320,0,1909
510000.0,3.0,1.5,2240,3800,2.0,1370,870,1929
1425000.0,4.0,4.25,4960,6000,2.5,3680,1280,1909
685000.0,3.0,1.75,1940,7313,1.0,1440,500,1960
350000.0,4.0,2.5,2040,22653,2.0,2040,0,2011
305000.0,2.0,2.25,1000,905,3.0,1000,0,2006
645000.0,3.0,3.25,1730,1229,2.0,1320,410,2008
385000.0,3.0,1.0,1220,4800,1.0,1220,0,1901
425000.0,3.0,1.75,1680,3000,1.0,840,840,1900
369000.0,3.0,2.0,1550,8509,1.0,1150,400,1959
650000.0,2.0,2.5,1740,2500,2.0,1210,530,1994
299950.0,3.0,1.0,1210,9525,1.0,1210,0,1955
715000.0,4.0,1.75,3420,7200,1.0,1770,1650,1947
659000.0,4.0,2.5,3190,11375,1.0,2210,980,1946
490000.0,3.0,1.75,1920,5405,1.0,960,960,1947
750000.0,3.0,1.75,1700,8400,1.0,1460,240,1947
700000.0,4.0,2.5,2310,3570,1.5,1490,820,1927
1365000.0,3.0,2.5,2090,6000,1.5,2090,0,1928
330000.0,2.0,2.5,1240,1546,2.0,1240,0,2007
560000.0,3.0,1.5,2000,7350,1.0,2000,0,1953
315000.0,3.0,2.0,1060,5750,1.0,1060,0,1981
399000.0,2.0,1.0,940,4800,1.0,940,0,1911
740000.0,5.0,3.75,3990,18897,2.0,3090,900,1937
280000.0,2.0,1.0,1880,7560,1.0,940,940,1919
750000.0,4.0,2.75,2600,4674,1.0,1560,1040,1976
427000.0,5.0,2.75,2220,4000,1.0,1230,990,1973
735000.0,4.0,3.0,2840,4120,1.5,2060,780,1931
240000.0,3.0,2.0,1330,6000,1.0,630,700,1900
645500.0,2.0,1.0,1890,5202,1.5,1890,0,1909
325000.0,3.0,1.75,2180,10230,1.0,1090,1090,1961
919204.0,4.0,3.5,3760,5000,2.0,2860,900,2014
615000.0,3.0,2.25,1760,1146,3.0,1760,0,2014
1505000.0,4.0,3.5,3480,7232,2.0,2580,900,1926
250000.0,1.0,1.0,750,4000,1.0,750,0,1918
315000.0,3.0,1.0,960,6634,1.0,960,0,1952
404000.0,3.0,1.5,2030,8880,1.0,1330,700,1963
285000.0,2.0,2.5,1380,1073,2.0,1140,240,2011
500000.0,3.0,2.0,1720,5525,1.0,960,760,1941
380000.0,2.0,1.0,1210,4800,1.0,1060,150,1950
469000.0,3.0,1.0,950,4250,1.5,950,0,1948
405000.0,2.0,1.75,1710,4234,2.0,1330,380,1920
629000.0,3.0,2.0,1760,5000,1.0,960,800,1920
395000.0,1.0,1.0,730,3000,1.0,730,0,1911
965000.0,4.0,2.5,2460,5000,2.0,1620,840,1938
820000.0,3.0,1.75,2160,6272,1.0,1390,770,1960
661000.0,4.0,2.25,1990,4600,1.5,1420,570,1932
686000.0,3.0,1.5,1840,9990,2.0,1840,0,1961
430000.0,2.0,1.0,990,4802,1.0,990,0,1947
809000.0,4.0,1.5,1840,4337,2.0,1840,0,1917
440150.0,2.0,1.0,1110,6800,1.0,1000,110,1947
455000.0,2.0,1.0,1170,6000,1.0,970,200,1941
635000.0,3.0,2.5,1960,7200,1.0,980,980,1940
985000.0,3.0,1.75,1670,5400,2.0,1670,0,1912
465500.0,3.0,1.75,1890,7004,1.0,1290,600,1965
730000.0,4.0,2.0,2360,6000,1.0,1260,1100,1939
550000.0,3.0,2.0,1810,4064,1.5,1810,0,1925
345000.0,3.0,1.75,1990,5650,1.0,1320,670,1963
342000.0,2.0,2.5,1175,1366,2.0,740,435,2005
610000.0,5.0,2.5,3990,3839,1.0,1990,2000,1962
455000.0,2.0,1.0,1140,5720,1.0,850,290,1947
540000.0,4.0,1.75,1720,4240,1.5,1460,260,1925
544000.0,3.0,1.5,1790,8203,1.5,1790,0,1910
400000.0,3.0,2.5,1495,936,3.0,1405,90,2006
425000.0,3.0,2.25,1660,6000,1.0,1110,550,1979
650000.0,5.0,2.75,2550,5040,1.5,2550,0,1902
850000.0,3.0,1.75,1370,3850,1.0,770,600,1911
930000.0,4.0,2.5,2200,4000,2.0,1430,770,1908
530000.0,3.0,1.75,1250,6041,1.5,1250,0,1942
500000.0,3.0,1.75,1620,4200,1.0,830,790,1945
1100000.0,4.0,3.75,2930,3200,1.5,2130,800,1925
689800.0,3.0,2.75,2390,9313,1.0,1390,1000,1942
430000.0,3.0,2.0,1360,5120,1.5,910,450,1924
785200.0,3.0,2.25,1840,3500,1.5,1540,300,1910
835000.0,4.0,2.75,1550,4000,1.5,1550,0,1930
440000.0,2.0,1.0,1230,6600,1.0,1130,100,1906
613000.0,3.0,2.5,1350,3068,2.0,1350,0,1991
660000.0,3.0,2.5,2290,2798,3.0,2290,0,1953
280000.0,2.0,1.5,1480,15641,1.0,1480,0,1940
235000.0,2.0,1.0,720,4840,1.0,720,0,1947
390000.0,3.0,2.0,1080,7236,1.0,1080,0,1947
710000.0,3.0,2.0,2140,4923,1.0,1070,1070,1928
312000.0,3.0,2.25,1540,5338,1.0,770,770,1954
545000.0,3.0,1.75,1810,3000,1.5,1810,0,1903
409950.0,2.0,1.75,1370,5125,1.0,1370,0,1944
960000.0,4.0,3.0,4590,9150,2.0,3490,1100,1981
847000.0,5.0,1.0,2550,4623,2.5,2550,0,1905
605000.0,3.0,2.0,2060,4040,1.0,1120,940,1947
425000.0,2.0,2.5,1140,1182,3.0,1140,0,2007
210000.0,3.0,1.0,1110,7962,1.0,1110,0,1962
718000.0,3.0,1.0,1030,4958,1.0,1030,0,1952
320000.0,3.0,3.25,1530,1602,2.0,1140,390,2013
390000.0,3.0,2.25,1250,7500,1.0,1250,0,1942
375000.0,4.0,1.75,2200,7475,1.0,1100,1100,1955
240500.0,3.0,1.75,1460,10584,1.0,990,470,1997
327500.0,3.0,1.0,1070,7140,1.0,1070,0,1989
280000.0,2.0,1.0,960,4920,1.0,960,0,1942
865000.0,3.0,1.75,2090,4725,2.0,1610,480,1947
135000.0,1.0,1.0,790,13062,1.0,790,0,1942
437000.0,2.0,1.75,1500,6800,1.0,910,590,1942
2400000.0,5.0,3.25,3410,9088,2.0,2760,650,1912
175000.0,2.0,1.0,670,2378,1.0,670,0,1919
465000.0,3.0,1.0,910,4500,1.0,910,0,1948
540000.0,3.0,1.0,1050,4160,1.0,1050,0,1925
525000.0,3.0,2.0,1540,7800,1.0,1540,0,2004
760500.0,3.0,2.0,1990,3990,1.0,1130,860,1912
519000.0,2.0,1.0,830,2820,1.0,830,0,1920
317000.0,3.0,1.0,1010,5400,1.0,1010,0,1959
371000.0,3.0,1.5,1420,4500,1.0,1420,0,1959
499950.0,3.0,2.5,1520,2208,2.0,1040,480,2007
375000.0,2.0,1.0,820,6250,1.0,820,0,1922
640000.0,3.0,2.5,1690,1553,2.5,1690,0,2007
989000.0,5.0,3.5,3280,4000,2.0,2440,840,2003
365000.0,2.0,1.0,1250,8100,1.0,1250,0,1947
411715.0,3.0,1.75,1840,5101,1.0,1040,800,1952
489000.0,3.0,1.5,1020,9072,1.0,920,100,1930
355000.0,2.0,1.75,1650,4000,1.0,950,700,1947
742000.0,3.0,3.25,1540,704,3.0,1540,0,2011
399950.0,3.0,1.5,2080,5244,1.0,1190,890,1959
767450.0,3.0,2.0,1630,7599,1.0,1630,0,2006
586500.0,3.0,2.5,1780,1487,3.0,1600,180,2006
455000.0,3.0,1.75,1420,1189,3.0,1420,0,2006
620000.0,4.0,2.25,2400,5350,1.5,1460,940,1929
269000.0,3.0,1.0,1690,4250,1.0,1020,670,1967
875000.0,3.0,3.5,3250,6000,2.0,2500,750,2001
647500.0,3.0,1.75,1290,3870,1.0,1290,0,1916
450000.0,4.0,1.0,2000,4676,1.5,1250,750,1916
440000.0,3.0,1.0,1050,7500,1.0,1050,0,1900
445000.0,4.0,2.5,2340,3784,2.0,2340,0,2008
875000.0,5.0,2.5,2920,5568,2.0,2320,600,1906
495000.0,5.0,3.0,2440,4750,1.0,1450,990,2006
1300000.0,6.0,4.5,3902,3880,3.0,2782,1120,1977
546000.0,2.0,1.0,970,3400,1.0,970,0,1924
700000.0,3.0,1.75,1910,4800,1.0,1080,830,1959
640000.0,3.0,1.75,2340,4206,1.0,1170,1170,1917
390000.0,3.0,2.0,1463,868,3.0,1463,0,2003
466500.0,3.0,1.0,1430,3840,1.0,950,480,1945
356000.0,2.0,1.0,920,4095,1.0,920,0,1914
229000.0,2.0,1.0,1190,7408,1.0,830,360,1941
619000.0,4.0,1.75,1660,3800,1.5,1660,0,1926
547000.0,3.0,2.5,1480,8381,1.0,1480,0,1968
499000.0,3.0,3.5,1690,1432,2.0,1360,330,2008
453500.0,4.0,1.75,2000,6032,1.0,1300,700,1959
456000.0,4.0,1.75,1670,9886,1.0,1670,0,1947
335000.0,3.0,2.0,1170,5360,1.0,1170,0,1919
605004.0,4.0,2.0,1370,4000,2.0,1370,0,1951
886000.0,4.0,2.0,2660,3900,1.5,1480,1180,1923
465000.0,3.0,2.25,1530,1245,2.0,1050,480,2014
584000.0,3.0,2.5,1480,1485,2.0,1280,200,2007
275000.0,3.0,3.0,1390,1080,2.0,1140,250,2006
324500.0,3.0,2.5,1660,3990,2.0,1660,0,2009
700000.0,3.0,2.5,2050,4185,2.0,2050,0,2011
385200.0,4.0,1.0,1550,7740,1.5,1550,0,1954
735000.0,4.0,2.5,2820,6180,2.0,2050,770,2013
389250.0,2.0,1.5,1490,4080,1.0,930,560,1956
545000.0,4.0,2.5,2040,6034,2.0,2040,0,1990
550000.0,3.0,1.5,1900,5000,1.5,1640,260,1926
500000.0,4.0,1.0,1720,4011,1.5,1720,0,1904
920000.0,4.0,2.75,2880,5750,1.5,1710,1170,1928
435000.0,2.0,1.0,1260,4080,1.5,1260,0,1926
1370000.0,2.0,2.25,2460,16940,1.5,1930,530,1936
253500.0,2.0,1.0,810,4800,1.0,810,0,1948
595000.0,4.0,2.5,1990,2175,2.0,1680,310,2005
660000.0,3.0,1.75,1980,3300,1.5,1140,840,1926
285000.0,2.0,1.0,780,5000,1.0,780,0,1943
435000.0,3.0,2.0,980,5000,1.0,980,0,1940
1280000.0,4.0,3.5,3010,3600,2.0,2370,640,1999
739000.0,4.0,3.0,2720,3800,2.0,1800,920,1919
452000.0,2.0,1.75,1740,5400,1.0,990,750,1946
279000.0,5.0,2.5,2690,5557,2.0,2690,0,2012
405000.0,2.0,2.0,1405,1073,2.0,1140,265,2007
490000.0,3.0,3.0,1730,2940,3.0,1730,0,1985
445000.0,2.0,1.0,1440,3225,1.0,960,480,1915
455000.0,3.0,1.0,1300,3550,1.5,1300,0,1927
410000.0,3.0,1.0,1410,5060,1.0,910,500,1956
450000.0,3.0,1.75,1640,13500,1.0,1110,530,1940
552000.0,2.0,2.5,1380,951,3.0,1380,0,2006
378500.0,2.0,1.0,730,7528,1.0,730,0,1946
304700.0,2.0,1.0,740,5995,1.0,740,0,1949
568000.0,3.0,1.75,2050,3520,1.0,1070,980,1977
345000.0,3.0,2.5,1210,1420,3.0,1210,0,2008
435000.0,3.0,2.25,1890,7200,1.0,1230,660,1973
400000.0,2.0,1.0,1140,5100,1.0,1140,0,1942
440000.0,3.0,1.75,2240,8153,1.0,1120,1120,1948
417000.0,2.0,1.0,920,6600,1.0,920,0,1919
435000.0,2.0,1.0,800,5000,1.0,800,0,1906
831000.0,4.0,2.5,2030,3905,1.5,1630,400,1926
425000.0,2.0,1.0,910,4635,1.0,910,0,1905
550000.0,4.0,2.5,2700,5100,1.0,1440,1260,1968
750000.0,4.0,3.25,2050,5000,2.0,1370,680,1987
550000.0,3.0,1.75,1380,3402,1.5,1380,0,1900
352750.0,2.0,1.75,1060,1241,2.0,960,100,2008
403950.0,2.0,1.0,710,1136,2.0,710,0,1943
980000.0,4.0,2.5,2730,4800,1.5,2230,500,1909
212500.0,2.0,2.0,1030,21712,1.0,1030,0,1938
428000.0,3.0,2.0,1310,2550,1.0,780,530,1986
559000.0,3.0,1.5,2070,5386,1.0,1140,930,1948
620000.0,3.0,2.5,2590,7237,2.0,2590,0,2004
240000.0,4.0,1.0,1910,16320,1.5,1910,0,1934
489000.0,3.0,3.5,1500,1249,2.0,1240,260,2004
398000.0,3.0,2.5,1720,1715,2.0,1240,480,2004
345000.0,2.0,1.5,1340,1210,2.0,1120,220,2008
365000.0,3.0,2.5,1800,2700,2.0,1800,0,2011
315000.0,3.0,2.5,1480,1590,2.0,1150,330,2010
571000.0,4.0,2.0,2750,7807,1.5,2250,500,1916
420000.0,2.0,1.0,860,3880,1.0,860,0,1916
700000.0,3.0,2.0,2080,3880,1.0,1160,920,1954
800000.0,3.0,2.25,1620,4500,2.0,1620,0,1926
440000.0,3.0,1.5,1290,1286,3.0,1290,0,2000
558000.0,4.0,2.0,2180,3870,1.0,1020,1160,1900
417500.0,4.0,1.0,1390,10800,1.5,1390,0,1941
1240000.0,5.0,3.0,2830,7500,2.0,2460,370,1923
480000.0,4.0,1.75,2320,4322,1.0,1140,1180,1910
659500.0,3.0,1.75,1820,5500,1.0,1620,200,1957
315000.0,2.0,1.0,1740,3622,1.0,950,790,1924
268000.0,2.0,1.0,1380,5000,1.0,870,510,1943
499000.0,2.0,1.0,1220,3000,1.0,920,300,1926
1070000.0,3.0,3.0,2940,4622,2.0,2230,710,1988
429000.0,3.0,3.25,1410,1246,3.0,1410,0,2005
403000.0,2.0,1.0,1100,3598,1.0,1100,0,1926
516200.0,3.0,2.0,2110,5150,1.0,1080,1030,1919
870000.0,4.0,2.5,3340,12248,2.0,2470,870,1998
429950.0,3.0,1.5,2010,9480,1.0,1570,440,1951
310000.0,3.0,2.5,1780,6771,1.0,1230,550,1990
555000.0,3.0,2.0,2180,4976,1.5,1680,500,1930
433000.0,3.0,1.75,1870,7189,1.0,1270,600,1959
566000.0,4.0,1.75,2440,5000,1.0,1340,1100,1954
700000.0,5.0,2.75,3100,9825,2.0,3100,0,1950
749000.0,3.0,1.0,1580,5000,1.5,1580,0,1926
680000.0,3.0,1.75,1760,8400,1.0,1460,300,1960
1059500.0,5.0,3.25,3230,3825,2.0,2480,750,2014
499950.0,2.0,2.25,1060,1208,2.0,940,120,2005
399950.0,2.0,1.0,710,1157,2.0,710,0,1943
850830.0,3.0,2.5,2070,13241,1.5,1270,800,1910
588000.0,4.0,2.0,1680,5000,1.0,980,700,1950
665000.0,6.0,3.0,4250,4400,2.5,3020,1230,1902
527000.0,2.0,1.75,1640,4080,1.0,840,800,1921
487028.0,2.0,1.5,1295,1093,2.0,1105,190,2007
799000.0,3.0,1.5,2210,6300,1.5,2210,0,1916
262500.0,3.0,1.5,1160,8906,1.0,1160,0,1962
220000.0,3.0,1.0,1050,6300,1.0,1050,0,1942
650000.0,2.0,1.0,1030,5750,1.0,1030,0,1928
435000.0,3.0,2.5,1420,2581,3.0,1420,0,2004
800000.0,4.0,3.75,2690,4000,2.0,2120,570,1909
295000.0,5.0,3.5,2100,5107,2.0,1410,690,1999
1085000.0,5.0,2.5,2340,6000,2.0,2340,0,1922
371000.0,3.0,1.0,890,7200,1.0,890,0,1951
514000.0,3.0,1.75,1720,5899,1.0,1220,500,1986
386000.0,3.0,1.5,1270,1318,2.0,1080,190,2004
740000.0,4.0,2.75,2490,17833,2.0,1490,1000,1979
465000.0,4.0,1.75,1470,5350,1.0,980,490,1955
700000.0,3.0,2.75,2500,7378,1.0,1390,1110,1948
350000.0,3.0,3.25,1460,1592,2.0,1130,330,2006
148000.0,1.0,1.0,620,8261,1.0,620,0,1939
530000.0,3.0,1.75,1550,3680,1.0,1050,500,1927
349000.0,3.0,2.5,1430,1002,3.0,1430,0,2002
735000.0,4.0,1.75,2460,5100,1.5,1450,1010,1909
476000.0,3.0,1.0,1140,5500,1.5,1140,0,1908
2888000.0,5.0,6.25,8670,64033,2.0,6120,2550,1965
110000.0,2.0,1.0,800,15000,1.0,800,0,1927
317000.0,3.0,1.0,1160,8813,1.0,1160,0,1952
460000.0,3.0,2.0,2060,4437,1.0,1030,1030,1929
405000.0,3.0,2.0,1640,7201,1.0,1640,0,1948
333000.0,2.0,1.0,720,6686,1.0,720,0,1942
427000.0,4.0,1.0,1860,4736,1.5,1860,0,1901
619400.0,4.0,2.0,2090,3610,1.5,1790,300,1927
881000.0,5.0,3.0,2510,4125,1.5,1590,920,1925
813000.0,4.0,2.75,3370,6675,1.0,1920,1450,1948
547500.0,3.0,3.5,1650,2262,3.0,1650,0,2010
399950.0,2.0,1.0,710,1131,2.0,710,0,1943
250000.0,2.0,1.5,982,846,2.0,806,176,2006
545000.0,2.0,1.25,1240,2150,2.0,1240,0,2014
2250000.0,5.0,4.25,4860,9453,1.5,3100,1760,1905
1095000.0,0.0,0.0,3064,4764,3.5,3064,0,1990
315000.0,2.0,1.0,970,5665,1.0,970,0,1908
678500.0,3.0,2.0,2460,6600,1.0,1370,1090,1952
580000.0,5.0,2.0,2060,6000,2.0,2060,0,1903
445000.0,3.0,1.0,1050,5664,1.0,910,140,1947
585000.0,3.0,2.5,1910,1501,2.5,1530,380,2007
480000.0,3.0,2.5,1250,1103,3.0,1250,0,2005
575000.0,2.0,1.0,1510,4032,1.5,1310,200,1935
350000.0,4.0,2.25,2300,4600,1.5,1340,960,1904
599000.0,5.0,2.75,2820,4608,1.0,1450,1370,1967
1184000.0,4.0,2.5,3200,7500,1.5,1860,1340,1948
545000.0,3.0,1.0,1510,5000,1.5,1510,0,1909
440000.0,3.0,1.0,1210,5750,1.5,1210,0,1910
445000.0,5.0,1.75,2460,6846,1.5,1340,1120,1911
397990.0,3.0,1.0,1180,11862,1.0,1180,0,1948
706000.0,3.0,2.75,1900,6400,1.0,1410,490,1942
363000.0,3.0,3.25,1651,1779,2.0,1341,310,2008
620000.0,2.0,1.0,1430,3000,1.5,1300,130,1929
448000.0,2.0,1.5,1630,3780,1.0,890,740,1940
670000.0,3.0,2.5,2050,6420,1.0,1730,320,1956
310000.0,5.0,3.0,1880,5000,1.0,1100,780,1997
1688000.0,4.0,2.5,3000,7500,2.0,3000,0,1937
495000.0,4.0,2.5,2140,7245,2.0,2140,0,2003
440000.0,3.0,1.0,1710,6556,1.5,1200,510,1926
280000.0,1.0,0.75,420,6720,1.0,420,0,1922
656500.0,4.0,2.0,2710,4750,1.0,1460,1250,1919
660000.0,3.0,3.0,2340,2970,2.0,2160,180,1925
560000.0,4.0,1.75,1880,3880,1.5,1090,790,1944
594000.0,4.0,1.75,1870,5200,2.0,1200,670,1937
600000.0,3.0,2.25,1480,5400,2.0,1480,0,1914
430000.0,4.0,1.75,1890,6000,1.0,1110,780,1947
312500.0,2.0,1.5,1070,1200,2.0,1070,0,1999
300000.0,3.0,3.25,1470,1235,2.0,1180,290,2008
822500.0,5.0,3.5,2320,4960,2.0,1720,600,1926
1125000.0,6.0,3.75,3010,4360,2.0,2000,1010,2014
285000.0,3.0,1.75,1840,8601,1.0,920,920,1905
370000.0,2.0,1.0,900,4600,1.0,900,0,1951
1030000.0,4.0,2.5,2750,4800,2.0,1960,790,1905
775000.0,4.0,2.0,3140,10875,1.0,1940,1200,1939
1335000.0,5.0,2.25,4200,5800,2.5,2910,1290,1906
499950.0,3.0,1.0,1830,3000,1.5,1430,400,1926
153000.0,3.0,1.0,1270,6405,1.5,1270,0,1944
585000.0,3.0,1.0,1870,2807,1.5,1580,290,1927
369500.0,3.0,1.5,1650,9957,1.0,1100,550,1961
305000.0,3.0,1.5,1210,5240,1.0,610,600,1983
215000.0,2.0,1.0,710,7200,1.0,710,0,1943
910000.0,5.0,2.5,2350,4000,2.0,2350,0,1993
513000.0,4.0,2.75,2020,7070,1.0,1010,1010,1958
1120000.0,5.0,1.5,2540,6660,2.0,2340,200,1954
385000.0,3.0,2.25,1920,4833,1.0,1060,860,1921
330000.0,3.0,2.5,1070,1155,2.0,720,350,2005
799000.0,3.0,2.5,2860,4442,2.0,2860,0,2000
589000.0,3.0,2.0,2250,8800,1.0,1250,1000,1925
1695000.0,2.0,2.25,3170,3000,2.0,1990,1180,1900
538000.0,3.0,1.0,1460,7200,1.0,1260,200,1906
530100.0,3.0,1.0,1540,3399,1.5,1200,340,1926
718500.0,3.0,2.0,2910,6600,2.0,1920,990,1900
556000.0,3.0,1.75,1640,7437,1.0,1090,550,1948
575000.0,3.0,3.0,1384,1287,2.0,1144,240,2006
530000.0,3.0,2.5,1930,7214,2.0,1930,0,2005
496752.0,2.0,1.0,1980,5000,1.0,1090,890,1923
330000.0,3.0,1.75,1430,8865,1.0,1430,0,1950
520500.0,3.0,2.0,1900,8100,1.0,950,950,1940
460000.0,3.0,1.75,1550,4708,1.0,860,690,1949
1735000.0,4.0,2.25,3040,5000,2.0,2080,960,1926
763101.0,3.0,1.75,1990,5560,1.0,1100,890,1939
460000.0,2.0,1.5,1090,4000,1.0,970,120,1951
825000.0,4.0,1.5,1890,6938,1.5,1890,0,1919
418000.0,4.0,3.0,2360,6250,1.0,1460,900,1960
690000.0,2.0,1.75,1600,4000,1.0,850,750,1918
300000.0,5.0,3.0,1940,6355,1.0,1200,740,2007
385000.0,4.0,1.75,1690,4080,1.0,870,820,1984
415000.0,4.0,2.0,1800,2970,1.0,1000,800,1923
235000.0,2.0,1.5,880,1805,2.0,880,0,1999
667000.0,3.0,1.5,1720,8100,2.0,1720,0,1907
375000.0,4.0,2.0,1240,3000,1.0,1040,200,1908
332000.0,1.0,1.0,960,2640,1.0,760,200,1908
1095000.0,4.0,4.0,3530,8400,2.0,2630,900,1958
277000.0,3.0,1.0,1100,8536,1.0,1100,0,1957
660000.0,6.0,1.75,1840,2774,1.0,1060,780,1900
524000.0,2.0,1.0,1120,2000,1.5,1120,0,1910
470000.0,3.0,1.5,1760,6723,1.0,1160,600,1958
460000.0,2.0,1.0,890,2100,1.0,760,130,1919
1712500.0,3.0,3.25,2940,5432,3.0,2440,500,1978
552000.0,3.0,1.0,1120,2300,1.0,820,300,1912
373000.0,3.0,1.0,1770,5720,1.5,1140,630,1926
245000.0,2.0,1.0,1200,4880,1.0,980,220,1943
450000.0,6.0,2.25,3550,11780,1.0,2960,590,1948
650000.0,4.0,2.75,2610,4160,3.0,1910,700,1910
378000.0,5.0,2.5,2760,8015,1.0,1600,1160,1960
340000.0,3.0,2.5,1212,1174,3.0,1212,0,2004
335000.0,3.0,1.5,2040,6000,1.0,1340,700,1957
523950.0,3.0,2.25,1420,1282,3.0,1420,0,2006
320000.0,3.0,2.25,1200,1400,3.0,1200,0,2005
468500.0,3.0,2.5,1350,1186,2.0,1120,230,2007
685000.0,4.0,3.5,2840,4637,3.0,2840,0,2008
435000.0,3.0,2.0,1980,2674,3.0,1980,0,2007
210000.0,1.0,1.0,930,7129,1.0,930,0,1948
560000.0,5.0,1.0,1710,9100,1.5,1320,390,1926
473000.0,2.0,1.0,900,5100,1.0,900,0,1909
870000.0,4.0,4.25,3010,4887,2.0,1940,1070,1951
475000.0,3.0,2.25,2280,5750,1.0,1150,1130,1985
458000.0,4.0,1.5,1550,3000,1.5,1350,200,1918
547000.0,4.0,1.0,1720,2800,1.5,1200,520,1926
379900.0,5.0,3.5,2800,7350,2.0,2800,0,1995
342000.0,2.0,1.0,740,6180,1.0,740,0,1948
640000.0,3.0,2.0,1380,4800,1.0,1380,0,1948
1010000.0,3.0,3.25,2420,1923,2.0,1840,580,2006
1008000.0,4.0,3.5,2650,3060,2.0,2060,590,2001
320000.0,3.0,1.0,860,5060,1.5,860,0,1927
479000.0,2.0,2.25,1230,932,2.0,1020,210,2004
472000.0,3.0,2.5,1180,1262,3.0,1180,0,2010
560000.0,3.0,2.0,2340,3477,1.0,1170,1170,1971
549000.0,2.0,2.5,1380,953,3.0,1380,0,2006
729000.0,3.0,1.0,1580,3840,2.0,1580,0,1908
465000.0,2.0,2.75,1430,1425,2.0,995,435,2006
675000.0,6.0,1.75,2740,6360,1.0,1370,1370,1953
667500.0,3.0,2.0,1880,3800,1.0,1030,850,1927
310000.0,4.0,2.0,1870,6000,1.5,1870,0,1956
435000.0,2.0,1.0,1230,3800,1.0,1230,0,1928
253000.0,3.0,1.5,880,6600,1.0,880,0,1945
554000.0,4.0,1.0,1120,7104,1.5,1120,0,1946
350000.0,3.0,2.0,1380,3600,3.0,1380,0,2013
1185001.0,3.0,2.75,2500,5568,2.0,2500,0,1905
2475000.0,3.0,3.25,4340,4947,2.0,3060,1280,1993
430000.0,3.0,1.0,980,7200,1.0,980,0,1950
824000.0,7.0,4.25,3670,4000,2.0,2800,870,1964
936000.0,3.0,1.75,2960,12420,1.0,1480,1480,1952
350000.0,2.0,2.5,1260,1347,3.0,1260,0,2005
435000.0,3.0,2.25,1230,1238,2.0,1080,150,2009
1555000.0,3.0,3.5,4360,6240,2.0,2960,1400,2008
475000.0,3.0,1.75,1700,8432,1.0,1230,470,1977
555000.0,3.0,1.75,2040,6000,1.0,1120,920,1958
384400.0,3.0,3.25,1689,1388,3.0,1689,0,2008
646000.0,5.0,2.75,2870,4461,1.0,1650,1220,1976
415000.0,3.0,1.75,1270,4800,1.0,1270,0,1952
545500.0,3.0,2.5,1560,9361,1.5,1360,200,1936
450000.0,3.0,1.75,1180,4080,1.0,760,420,1928
650000.0,5.0,1.75,1260,4500,1.5,1260,0,1926
343566.0,2.0,1.0,1100,4200,1.0,1100,0,1954
190000.0,1.0,1.0,720,4800,1.0,720,0,1914
1400000.0,3.0,2.0,2020,5500,1.5,1790,230,1937
175000.0,2.0,1.0,660,5000,1.0,660,0,1915
175000.0,6.0,1.0,1370,5080,1.5,1120,250,1931
559000.0,2.0,1.0,1240,6400,1.0,1060,180,1938
240000.0,2.0,1.0,670,10920,1.0,670,0,1942
300000.0,3.0,2.5,1700,3575,2.0,1700,0,2000
400000.0,3.0,1.75,1050,6150,1.5,950,100,1928
825000.0,4.0,3.5,3810,9792,2.0,3810,0,1938
855000.0,4.0,2.25,2190,4080,2.0,1800,390,1918
465000.0,3.0,1.75,1510,4800,1.0,860,650,1925
515000.0,3.0,3.5,1360,1419,2.0,1040,320,2007
309000.0,3.0,2.25,1490,1294,2.0,1220,270,2010
485000.0,2.0,2.5,1430,923,3.0,1410,20,2008
482000.0,3.0,3.25,1380,1120,3.0,1380,0,2008
690000.0,3.0,3.25,1540,1428,3.0,1540,0,2013
576000.0,3.0,2.5,1940,9000,1.0,970,970,1948
378750.0,3.0,2.5,2160,3000,1.5,1260,900,1909
1525000.0,4.0,3.25,3620,5131,2.0,2350,1270,1927
405000.0,2.0,1.0,1260,4377,1.0,1260,0,1947
703000.0,3.0,2.0,1360,5980,1.5,1360,0,1945
464000.0,3.0,1.0,1320,3625,2.0,1320,0,1900
945000.0,2.0,2.5,2540,7089,2.0,2540,0,2004
1325000.0,4.0,2.5,2440,3600,2.5,2440,0,1902
799000.0,4.0,2.5,2590,7910,2.0,2590,0,2001
1309500.0,4.0,4.5,4750,13912,2.0,3600,1150,2005
590300.0,3.0,1.5,1470,7200,2.0,1470,0,1907
506000.0,2.0,1.0,1570,8210,1.0,1150,420,1952
285000.0,3.0,1.0,1210,4731,1.5,1210,0,1901
311000.0,3.0,1.75,1900,3000,1.5,1070,830,1903
435000.0,3.0,1.75,1310,8065,1.0,1310,0,1948
1440000.0,3.0,3.5,3870,3819,2.0,2760,1110,2002
756000.0,4.0,2.25,2160,5600,1.0,1080,1080,1947
248000.0,4.0,2.0,2080,13510,1.0,1040,1040,1950
399888.0,4.0,2.25,1820,8255,1.5,1320,500,1930
899000.0,4.0,2.25,2370,6000,1.0,1440,930,1959
436000.0,2.0,1.0,790,6600,1.0,790,0,1949
680000.0,6.0,2.0,1670,3000,1.0,900,770,1911
549000.0,4.0,1.75,1290,3060,2.0,1290,0,1906
618250.0,4.0,3.25,2520,3360,1.5,1550,970,1931
850000.0,2.0,1.75,1590,5136,1.5,1320,270,1927
930000.0,5.0,2.0,3530,9385,1.5,3530,0,1925
499000.0,3.0,1.75,1840,5000,1.0,920,920,1910
507000.0,3.0,2.5,2120,7201,2.0,2120,0,2003
646000.0,4.0,2.5,2310,4079,2.0,2310,0,2008
475000.0,3.0,2.5,950,1110,2.0,950,0,2003
319950.0,2.0,1.0,920,8341,1.0,920,0,1939
543000.0,3.0,2.25,1240,949,3.0,1240,0,2008
607500.0,3.0,3.25,1530,1612,3.0,1530,0,2006
395000.0,3.0,1.0,1500,4000,1.0,900,600,1925
600000.0,2.0,1.0,1040,3600,1.0,1040,0,1919
450000.0,3.0,2.0,1430,3480,1.0,980,450,1947
480000.0,4.0,1.0,2080,5500,1.0,1040,1040,1941
850000.0,3.0,2.25,2870,8170,2.0,2250,620,1995
380000.0,3.0,1.5,1520,4288,1.0,1020,500,1949
359950.0,3.0,2.25,1940,11612,1.0,1100,840,1981
665900.0,4.0,2.25,2870,5453,2.0,2220,650,1926
547000.0,5.0,2.5,2200,4080,1.5,1420,780,1916
640000.0,2.0,1.75,1760,4400,1.0,880,880,1930
587206.0,3.0,3.5,1890,1710,2.0,1640,250,1999
511500.0,4.0,1.0,1360,6000,1.5,1360,0,1917
412000.0,2.0,1.0,1260,3960,1.0,690,570,1925
400000.0,3.0,1.0,1430,10005,1.5,1430,0,1950
250000.0,1.0,1.0,800,16306,1.0,680,120,1931
1300000.0,5.0,4.0,3366,7800,2.5,2966,400,1937
1462497.0,5.0,3.25,3840,4800,3.0,2750,1090,2008
355000.0,4.0,2.5,2040,8265,2.0,2040,0,1996
915000.0,3.0,3.25,2660,4000,2.0,2170,490,2003
2400000.0,6.0,4.5,5480,10800,2.0,4430,1050,1999
390000.0,3.0,1.0,1160,3750,1.5,1160,0,1910
482500.0,4.0,3.0,1630,7626,1.0,1110,520,1990
525000.0,3.0,2.25,1750,1879,3.0,1750,0,2001
725000.0,6.0,1.75,2380,4080,2.0,2380,0,1917
780000.0,3.0,2.25,2140,3000,2.0,2140,0,1905
325000.0,2.0,1.0,840,4239,1.0,840,0,1948
489000.0,4.0,2.0,2120,11479,1.0,1060,1060,1940
625000.0,3.0,2.5,2440,4800,2.0,2440,0,2014
654000.0,3.0,3.25,1530,1565,2.0,1280,250,2005
375000.0,2.0,1.0,1230,1820,2.0,830,400,1948
849000.0,4.0,2.0,2160,6300,1.5,2160,0,1928
442900.0,4.0,1.75,1780,2788,1.0,890,890,1943
750000.0,3.0,1.75,2610,5544,1.5,1680,930,1934
565000.0,2.0,1.75,1330,6000,1.0,960,370,1914
802000.0,3.0,1.75,2870,5000,1.5,1840,1030,1907
577000.0,3.0,2.5,2060,5750,1.0,1330,730,1976
690000.0,2.0,1.0,970,4560,1.0,970,0,1907
430000.0,2.0,1.5,950,4625,1.0,950,0,1949
775000.0,4.0,2.5,2300,6158,2.0,2300,0,1999
449000.0,4.0,2.5,1850,5040,1.0,1230,620,1930
420000.0,3.0,2.0,1200,5029,1.0,880,320,1937
735000.0,4.0,2.25,2270,5102,1.0,1340,930,1954
286000.0,3.0,2.75,1100,750,2.0,780,320,2008
579000.0,3.0,2.5,1640,1269,3.0,1640,0,2009
345100.0,3.0,3.75,1950,8625,1.0,1360,590,1959
649950.0,3.0,2.5,1500,1375,2.0,1200,300,2014
458500.0,3.0,2.0,1890,1599,2.0,1430,460,2012
500000.0,3.0,1.0,1150,5100,2.0,1150,0,1911
345000.0,3.0,1.0,1140,4200,2.0,1140,0,1904
399950.0,3.0,1.75,1560,5223,1.0,810,750,1940
360000.0,4.0,1.5,1720,6417,1.0,1720,0,1953
234000.0,2.0,1.0,870,11100,1.0,870,0,1940
490000.0,3.0,2.25,1470,2500,2.0,1080,390,1984
615000.0,5.0,2.0,2130,4180,1.5,1270,860,1926
396500.0,3.0,1.75,2390,7149,1.0,1350,1040,1955
405000.0,2.0,1.0,860,2599,1.0,860,0,1901
265000.0,3.0,1.0,1620,9450,1.5,1620,0,1928
525000.0,2.0,1.0,1080,3500,1.0,1080,0,1924
415000.0,4.0,2.5,2170,8518,1.0,1350,820,1955
1580000.0,4.0,2.5,4570,74487,2.0,4570,0,1948
450000.0,4.0,1.75,2160,4333,1.0,1260,900,1942
471001.0,3.0,1.75,1800,6000,1.0,900,900,1905
385000.0,3.0,3.25,1630,1677,3.0,1630,0,2007
335000.0,1.0,1.0,720,5100,1.0,720,0,1907
1220000.0,4.0,3.75,3520,3944,1.5,2200,1320,1913
750000.0,3.0,2.0,1820,5000,1.5,1720,100,1941
569000.0,4.0,2.0,1730,3884,1.0,1060,670,1924
800000.0,4.0,3.0,3520,4895,1.0,1980,1540,1954
660000.0,3.0,3.25,1980,2850,3.0,1980,0,1987
685000.0,2.0,1.5,1300,1676,1.0,1300,0,1943
403500.0,3.0,1.0,1830,8004,1.0,1200,630,1960
405000.0,3.0,2.25,1520,1245,3.0,1520,0,2004
345000.0,3.0,1.5,1420,1192,2.0,1140,280,2008
160797.0,3.0,1.5,1270,2356,2.0,1270,0,2012
562500.0,3.0,2.25,1300,907,2.0,1000,300,2006
664950.0,5.0,3.0,3190,7081,1.0,1890,1300,2013
515000.0,5.0,3.25,2910,5027,2.0,2040,870,2013
670000.0,3.0,2.5,3310,5300,2.0,2440,870,2008
362500.0,2.0,1.5,940,1768,2.0,940,0,2009
402101.0,2.0,0.75,1020,1350,2.0,1020,0,2009
438000.0,3.0,1.75,1520,6380,1.0,790,730,1948
687500.0,4.0,1.75,2330,5000,1.5,1510,820,1929
880000.0,4.0,2.5,3030,3841,3.0,3030,0,2005
819000.0,3.0,3.5,2130,6150,2.0,1530,600,1908
530000.0,2.0,1.5,1580,3680,1.0,1280,300,1941
615000.0,2.0,1.0,1270,5000,1.0,1090,180,1949
660000.0,2.0,2.25,2550,6000,2.0,1860,690,1902
665000.0,6.0,2.75,2840,8346,1.0,1420,1420,1961
1157400.0,3.0,2.5,2740,5925,2.0,2740,0,1913
2466350.0,5.0,4.75,6390,13180,2.0,4560,1830,1940
339000.0,4.0,2.0,2470,5080,1.5,1970,500,1948
615000.0,3.0,1.75,1720,4080,1.0,960,760,1924
941000.0,4.0,1.75,2320,3825,1.5,1820,500,1926
485000.0,3.0,2.5,1500,5412,1.0,900,600,1920
339000.0,3.0,1.0,1100,4128,1.0,720,380,1942
455000.0,2.0,1.5,1200,1259,2.0,1000,200,2013
510000.0,3.0,2.25,1420,1309,3.0,1420,0,2006
230000.0,4.0,1.75,1850,6000,1.0,1270,580,1944
300000.0,2.0,1.0,750,5120,1.0,750,0,1941
457500.0,3.0,2.25,1430,2003,2.0,980,450,1996
343500.0,4.0,1.75,1760,6204,1.0,1180,580,1950
257500.0,2.0,2.0,1180,9265,1.0,1180,0,1940
317000.0,5.0,2.5,2360,11375,1.0,1180,1180,1962
970000.0,3.0,2.25,3060,9950,1.5,1810,1250,1930
683500.0,3.0,1.5,1820,5756,1.5,1640,180,1946
355000.0,2.0,2.25,930,747,2.0,630,300,2007
395000.0,4.0,1.75,1540,5120,1.0,770,770,1943
218000.0,3.0,1.0,880,18205,1.0,880,0,1945
350000.0,2.0,1.0,740,7680,1.0,740,0,1922
845000.0,3.0,2.0,2540,4750,1.5,1840,700,1930
850000.0,4.0,3.0,3330,4000,1.0,1790,1540,1958
329950.0,2.0,1.0,900,5220,1.0,900,0,1956
425000.0,4.0,1.5,1600,6180,1.5,1600,0,1946
210000.0,2.0,1.0,970,5500,1.0,970,0,1956
631500.0,2.0,1.0,1130,2640,1.0,1130,0,1927
295000.0,2.0,1.0,650,5400,1.0,650,0,1950
575000.0,3.0,2.25,2400,5000,1.5,1440,960,1926
329445.0,2.0,1.5,830,1119,2.0,830,0,2005
395000.0,3.0,2.5,1600,1936,2.0,1600,0,2007
890000.0,4.0,1.0,2550,4000,2.0,2370,180,1905
352000.0,4.0,1.0,1530,8890,1.0,980,550,1925
800000.0,2.0,1.0,1740,5719,1.0,1740,0,1955
381500.0,2.0,1.0,900,2910,1.0,900,0,1924
562100.0,2.0,0.75,1440,3700,1.0,1200,240,1914
308000.0,3.0,1.0,1640,18144,1.5,1640,0,1942
750000.0,3.0,1.5,1840,5000,1.5,1340,500,1915
657000.0,4.0,2.5,2180,3375,1.5,1420,760,1926
575000.0,3.0,2.25,1700,3333,1.5,1100,600,1924
690500.0,5.0,2.0,2000,4211,1.5,1280,720,1908
500000.0,3.0,1.5,1190,4750,1.0,970,220,1940
870000.0,4.0,2.75,2840,4000,1.5,1960,880,1912
275000.0,2.0,1.0,770,4840,1.0,770,0,1927
645000.0,3.0,2.75,1850,16960,1.0,1850,0,1953
315000.0,4.0,2.0,1780,5336,1.5,930,850,1918
190000.0,1.0,0.75,930,29258,1.0,930,0,1941
310000.0,2.0,1.0,870,5400,1.0,870,0,1950
265950.0,3.0,1.5,1150,8450,1.0,1150,0,1951
860000.0,5.0,3.25,4500,9648,2.0,3000,1500,1968
402000.0,4.0,2.25,2000,3672,2.0,1650,350,1926
305000.0,6.0,2.0,1900,8240,1.0,1200,700,1964
1355000.0,3.0,1.5,2680,4775,2.0,1880,800,1913
650000.0,4.0,2.75,1910,16532,1.0,1420,490,1940
270000.0,2.0,1.0,2060,8398,1.0,1260,800,1962
435000.0,2.0,1.0,1060,3036,1.5,1060,0,1943
594000.0,3.0,2.25,1270,1406,2.0,1060,210,2014
450000.0,4.0,2.75,2310,5650,1.0,1330,980,1952
760000.0,4.0,2.5,2760,6000,2.0,2230,530,1942
346500.0,2.0,1.75,1610,6300,1.0,1010,600,1941
1330000.0,3.0,1.5,1940,2885,1.5,1940,0,1900
640000.0,3.0,1.75,1620,6000,1.0,1040,580,1947
957000.0,5.0,3.25,3160,5000,2.0,2180,980,2005
680000.0,4.0,1.5,1880,6200,1.0,1440,440,1954
450000.0,2.0,1.0,1380,4390,1.0,880,500,1931
595888.0,3.0,1.75,1870,9000,1.0,1870,0,1958
346500.0,3.0,1.0,1150,11802,1.0,1150,0,1932
519000.0,4.0,2.5,1950,2617,1.5,1250,700,1910
395000.0,2.0,2.25,1350,1493,2.0,1050,300,2007
364000.0,3.0,2.5,1800,2790,2.0,1800,0,2011
328423.0,3.0,2.5,1730,3600,2.0,1730,0,2014
425000.0,3.0,2.5,2320,2267,3.0,2320,0,2009
563500.0,3.0,2.5,1400,1312,3.5,1400,0,2007
975000.0,5.0,3.0,2620,5477,2.0,2620,0,2009
937000.0,3.0,1.75,2450,2691,2.0,1750,700,1915
518500.0,3.0,3.5,1590,1102,3.0,1590,0,2010
415000.0,3.0,1.0,1170,6700,1.0,1170,0,1957
357250.0,3.0,1.5,1400,8840,1.0,1400,0,1952
725000.0,6.0,3.0,3110,5000,1.5,1810,1300,1921
670000.0,3.0,1.5,1490,4400,1.5,1490,0,1906
440000.0,4.0,1.5,1770,5750,2.0,1770,0,1947
320000.0,2.0,1.0,950,5316,1.0,950,0,1948
690000.0,5.0,3.5,2720,7598,2.0,1860,860,1993
805000.0,3.0,2.75,2600,5875,1.5,1600,1000,1929
446000.0,2.0,1.5,1370,1221,2.0,1080,290,2008
402000.0,2.0,1.0,620,2475,1.0,620,0,1911
270000.0,4.0,2.25,2600,9900,1.0,1600,1000,1965
755000.0,4.0,2.75,2880,4000,1.5,2100,780,1912
1145000.0,3.0,2.5,2490,4000,2.0,1670,820,1918
1250000.0,3.0,3.0,3760,8500,2.5,3060,700,1910
450000.0,2.0,1.75,840,3340,1.0,700,140,1912
339000.0,2.0,1.0,950,7954,1.0,950,0,1941
1340000.0,4.0,3.5,3190,5040,2.0,2160,1030,2003
815000.0,4.0,2.75,2620,4743,1.0,1310,1310,1949
638000.0,3.0,2.0,1660,3729,1.0,970,690,1922
750000.0,4.0,2.75,1750,5080,1.5,1750,0,1903
626000.0,3.0,1.75,2430,5000,2.0,1760,670,1945
440000.0,3.0,1.5,2120,6290,1.0,1220,900,1949
900000.0,4.0,3.5,3370,5000,2.0,2470,900,2008
1990000.0,5.0,3.0,4480,5000,2.5,3420,1060,1902
1387800.0,3.0,3.0,2480,5500,2.0,1730,750,1950
471000.0,2.0,1.75,1240,6417,1.0,1240,0,1924
663000.0,3.0,2.0,1480,3876,1.0,860,620,1928
240000.0,4.0,1.0,1200,2171,1.5,1200,0,1933
390000.0,3.0,3.25,1370,913,2.0,1100,270,2006
665000.0,2.0,1.0,1110,3200,1.0,1110,0,1925
672500.0,3.0,2.25,2400,5300,1.5,1250,1150,1939
417000.0,4.0,2.25,2300,7700,1.0,1380,920,1959
700000.0,3.0,2.5,1660,1545,2.0,1400,260,2002
561500.0,3.0,1.75,1960,6380,1.0,980,980,1939
447000.0,2.0,1.0,1320,8380,1.0,1320,0,1953
212700.0,2.0,1.0,940,5040,1.0,940,0,1926
260000.0,2.0,1.0,700,4800,1.0,700,0,1922
430000.0,2.0,1.0,1050,2570,1.0,850,200,1927
221000.0,3.0,1.0,910,8789,1.0,910,0,1966
500000.0,4.0,1.0,1440,7100,1.5,1440,0,1906
191000.0,2.0,1.0,900,3400,1.0,900,0,1905
315000.0,6.0,4.0,3120,4240,2.0,2090,1030,1993
415000.0,3.0,2.5,1060,1536,2.0,1060,0,2000
523460.0,5.0,1.75,1890,5000,1.5,1090,800,1906
710000.0,2.0,1.5,1640,4080,1.5,1540,100,1916
1020000.0,3.0,2.25,1670,4800,1.5,1670,0,1903
480000.0,2.0,1.0,1500,3420,1.0,1500,0,1902
397000.0,5.0,1.0,1170,6757,1.0,800,370,1944
718500.0,3.0,1.5,1200,6240,1.0,1030,170,1952
195000.0,2.0,1.0,1020,8100,1.0,1020,0,1940
295000.0,1.0,1.0,700,2500,1.0,700,0,1907
504200.0,2.0,1.5,1200,1687,3.0,1200,0,2008
589500.0,3.0,3.25,2310,3075,2.0,1730,580,2005
735000.0,3.0,2.25,1490,1212,2.0,1040,450,2011
235000.0,1.0,1.5,1170,1456,2.0,1070,100,2007
229800.0,2.0,1.75,1110,1773,2.0,1110,0,2014
516500.0,1.0,1.25,1100,638,3.0,1100,0,2014
1600000.0,3.0,4.25,2820,7200,2.0,2460,360,1930
470000.0,3.0,1.5,1500,5000,1.5,1140,360,1927
650000.0,2.0,1.0,1050,2542,1.0,880,170,1904
585000.0,5.0,2.5,2670,16777,1.5,1620,1050,1920
475000.0,3.0,2.5,1700,9100,1.0,1160,540,1998
397000.0,3.0,3.5,1360,1275,2.0,1240,120,2007
325000.0,5.0,2.75,2130,6222,1.0,1300,830,1991
1200000.0,4.0,2.0,2120,3360,2.0,2120,0,1905
410000.0,1.0,1.5,1010,5750,1.0,1010,0,1911
1165000.0,3.0,3.0,3790,5001,2.0,2810,980,1989
669500.0,4.0,2.25,2500,4046,1.5,1520,980,1940
491950.0,3.0,2.25,2090,10733,1.0,1440,650,1958
535000.0,3.0,1.0,1580,6300,1.0,1180,400,1925
490000.0,4.0,3.0,2330,3497,2.0,1920,410,2003
345000.0,2.0,1.0,970,5750,1.0,970,0,1932
441000.0,2.0,1.5,1190,3400,1.0,990,200,1919
406500.0,2.0,1.0,870,5750,1.0,870,0,1947
1925000.0,5.0,4.25,4830,8050,2.5,3710,1120,1914
408000.0,5.0,3.25,2820,6589,1.5,2320,500,1906
875000.0,4.0,1.5,1800,3245,1.5,1800,0,1929
308000.0,3.0,1.0,1010,8800,1.0,1010,0,1954
880000.0,4.0,2.75,3220,4392,1.5,2320,900,1931
255000.0,2.0,1.0,1320,9967,1.0,940,380,1919
850000.0,3.0,2.5,2650,2387,2.0,1830,820,1920
265000.0,2.0,2.0,1860,10856,1.0,1260,600,1952
972000.0,4.0,1.75,2010,6300,1.0,1610,400,1937
544000.0,3.0,2.5,1460,1613,2.0,1180,280,2007
427500.0,2.0,2.0,1090,934,3.0,1090,0,2008
435000.0,4.0,2.0,1880,3840,1.0,970,910,1904
765000.0,5.0,3.0,2870,5700,1.0,1950,920,1964
457000.0,3.0,2.5,1220,1330,2.0,1010,210,2008
349500.0,3.0,2.0,1270,3600,1.0,1270,0,1963
1198000.0,4.0,3.5,3400,3850,2.5,2790,610,2008
330000.0,3.0,2.5,1680,11312,1.0,1080,600,1959
500000.0,2.0,1.0,950,4500,1.0,850,100,1926
691500.0,4.0,2.5,2600,7200,2.0,2600,0,1962
459500.0,2.0,1.0,1250,3825,1.0,850,400,1929
955500.0,4.0,1.75,2130,5080,1.5,2130,0,1914
1297000.0,6.0,2.75,2630,9420,2.0,2510,120,1900
616000.0,4.0,1.75,1700,5846,1.0,1700,0,1957
345000.0,2.0,1.0,1080,7775,1.0,1080,0,1955
370000.0,2.0,1.0,860,6050,1.0,860,0,1952
1080000.0,3.0,2.75,3890,7216,2.0,3260,630,1967
337000.0,3.0,2.25,1460,941,3.0,1460,0,2006
563000.0,4.0,1.0,1410,3376,1.5,1410,0,1911
1695000.0,4.0,2.75,3770,10900,2.0,3070,700,1924
245000.0,3.0,2.0,1190,4072,1.5,1190,0,1907
590000.0,3.0,2.0,1410,6413,1.0,910,500,1947
695000.0,3.0,2.0,2500,4080,1.5,1680,820,1922
402500.0,2.0,1.0,800,2280,1.0,800,0,1946
600000.0,5.0,2.25,2980,7781,1.0,1580,1400,1960
1110000.0,5.0,3.25,3350,4000,2.0,2510,840,1997
332888.0,2.0,2.5,1050,1029,2.0,950,100,2007
515000.0,2.0,1.0,1050,5000,1.0,1050,0,1907
485000.0,4.0,1.75,1430,4096,2.0,1430,0,1900
1640000.0,3.0,3.25,3140,5445,2.0,2240,900,1913
102500.0,2.0,1.0,820,4320,1.0,820,0,1937
600000.0,2.0,1.0,910,2002,1.5,910,0,1900
406000.0,4.0,1.0,1580,8475,1.5,1580,0,1928
620000.0,4.0,3.0,2130,6325,1.0,1440,690,1948
725000.0,3.0,1.75,1860,6000,2.0,1860,0,1959
276000.0,1.0,0.75,370,1801,1.0,370,0,1923
2300000.0,4.0,4.75,3970,9778,2.0,3390,580,1928
433000.0,4.0,1.5,1550,5053,1.0,1180,370,1963
581000.0,4.0,1.0,1630,2566,1.5,1630,0,1921
952500.0,4.0,1.5,2550,5055,2.0,2550,0,1910
476000.0,4.0,3.0,2890,6885,1.0,1590,1300,1945
535000.0,4.0,1.75,1420,5000,1.5,1420,0,1945
1356925.0,4.0,3.5,4270,5800,2.0,3170,1100,1937
640000.0,2.0,2.25,1540,965,3.0,1540,0,2007
460000.0,3.0,2.5,1450,1053,2.0,940,510,2008
525000.0,2.0,2.5,1160,1458,2.0,1040,120,2012
512031.0,3.0,1.75,1540,3000,1.0,770,770,1920
310000.0,2.0,1.0,700,3000,1.0,700,0,1918
1075000.0,3.0,2.5,3280,10302,1.0,1680,1600,1970
255000.0,4.0,2.0,2430,8960,1.0,1430,1000,1960
895000.0,4.0,2.25,1950,5950,1.0,1330,620,1947
580000.0,3.0,2.25,1900,3960,1.5,1200,700,1905
480000.0,3.0,2.0,1470,10052,1.0,1470,0,1956
185000.0,5.0,1.0,1590,6700,1.5,1090,500,1942
690000.0,3.0,1.5,1760,4000,2.0,1760,0,1922
540000.0,3.0,2.25,1320,1800,2.0,1320,0,1994
732000.0,3.0,3.75,2670,6517,2.5,2020,650,1977
860000.0,4.0,1.75,1880,3720,1.5,1880,0,1924
389000.0,4.0,1.75,2400,7700,1.5,1500,900,1927
645000.0,3.0,1.75,2270,11472,1.0,1370,900,1956
550000.0,4.0,2.75,2160,5005,1.0,1430,730,1987
782000.0,2.0,1.5,1570,3600,1.5,1320,250,1906
545000.0,3.0,2.0,1340,7200,1.5,1340,0,1923
723000.0,4.0,2.25,2430,4748,1.5,1630,800,1928
496000.0,2.0,1.0,900,9260,1.0,900,0,1946
625000.0,3.0,3.0,1820,1641,3.0,1540,280,2006
475000.0,4.0,2.0,2100,13468,1.0,1050,1050,1962
660500.0,5.0,2.5,2950,5500,1.5,1720,1230,1918
262000.0,5.0,1.0,1870,7800,1.0,1580,290,1962
2147500.0,3.0,3.5,4660,5500,2.0,3040,1620,1909
736000.0,2.0,1.0,1500,4000,1.0,1100,400,1933
1054690.0,4.0,3.5,3390,3979,2.0,2610,780,2014
334500.0,2.0,1.5,830,1858,2.0,830,0,2005
265050.0,2.0,1.5,800,2119,2.0,800,0,2008
445838.0,3.0,2.5,2250,5692,2.0,2250,0,2000
575000.0,3.0,1.75,1530,6743,1.0,1410,120,1955
850000.0,3.0,2.5,3230,5000,2.0,2430,800,1945
1015000.0,3.0,3.25,3620,4000,2.0,2730,890,2005
588000.0,5.0,3.0,2190,4900,2.0,1490,700,1940
715000.0,3.0,4.0,2080,2250,3.0,2080,0,1997
529950.0,3.0,1.0,1240,5000,1.5,1240,0,1909
1755000.0,3.0,2.0,2360,4800,2.0,2360,0,1909
554729.0,4.0,2.5,2020,4350,2.0,1730,290,1943
341000.0,3.0,1.0,1390,4814,1.5,1390,0,1908
430000.0,3.0,1.5,1810,5080,1.0,1030,780,1958
220000.0,4.0,1.0,1200,6000,1.5,1200,0,1923
1625000.0,4.0,3.25,2980,3600,2.0,2150,830,1999
405500.0,2.0,2.75,1350,1252,2.0,1120,230,2006
633000.0,4.0,2.5,2360,10000,1.0,1980,380,1977
255000.0,2.0,1.5,920,1598,2.0,920,0,1995
370000.0,2.0,1.0,860,5040,1.0,860,0,1956
975000.0,6.0,2.75,2520,54160,2.0,2520,0,1954
439990.0,3.0,2.5,1930,1348,2.0,1300,630,2005
609000.0,3.0,1.75,1630,1526,3.0,1630,0,2014
425000.0,3.0,1.5,1400,1022,3.0,1400,0,2007
1200000.0,4.0,2.5,2700,4275,2.0,2700,0,2004
1738000.0,4.0,2.25,2920,6513,2.0,2260,660,1937
671000.0,4.0,3.0,3130,5700,1.5,1750,1380,1953
459500.0,3.0,1.75,1470,4950,1.0,1030,440,1984
499000.0,3.0,2.5,1540,1326,3.0,1390,150,1995
1280000.0,4.0,2.5,3160,4620,1.5,2020,1140,1917
382500.0,2.0,1.0,1190,4440,1.0,1190,0,1981
530000.0,3.0,1.75,1320,2500,1.0,870,450,1918
548800.0,4.0,1.0,1660,4704,1.5,1260,400,1930
588000.0,3.0,2.0,1860,4777,2.0,1860,0,1908
445000.0,2.0,2.0,1240,2500,2.0,1240,0,1985
300000.0,3.0,1.0,930,5160,1.5,930,0,1919
527000.0,6.0,3.5,3000,8401,1.0,1500,1500,1979
335950.0,2.0,1.5,800,5192,1.0,800,0,1951
295000.0,3.0,1.5,1640,7222,2.0,1640,0,1908
780000.0,4.0,2.0,2600,4800,1.0,1400,1200,1953
437500.0,3.0,2.0,1490,4800,2.0,1490,0,1948
443000.0,5.0,1.75,1650,3000,1.5,1650,0,1902
245000.0,2.0,1.0,1500,6685,1.0,1190,310,1926
536000.0,2.0,1.5,1130,746,2.0,1030,100,2009
558000.0,2.0,2.0,1580,5750,1.0,790,790,1910
1636000.0,3.0,2.5,3110,6765,2.0,2550,560,1946
631500.0,4.0,2.0,2530,5650,1.5,1910,620,1910
570000.0,3.0,2.0,1640,2808,1.0,820,820,1924
1450000.0,4.0,3.25,3770,4103,2.0,2710,1060,1925
500000.0,3.0,2.5,1720,3012,2.0,1720,0,2011
378000.0,3.0,2.5,1601,2491,3.0,1536,65,2007
505000.0,2.0,2.25,1060,1209,2.0,940,120,2006
510000.0,3.0,2.5,1420,1237,3.0,1420,0,2014
1300000.0,4.0,2.25,2360,4000,2.0,2360,0,2013
374000.0,2.0,1.5,1260,1575,2.0,1260,0,2001
230000.0,3.0,1.75,1140,1201,2.0,1140,0,2014
438000.0,2.0,2.0,1270,1372,3.0,1270,0,2000
315000.0,2.0,1.0,1080,2674,1.0,720,360,1919
780000.0,2.0,2.5,2560,2500,2.0,1690,870,1901
480000.0,2.0,1.0,1060,3040,1.0,860,200,1924
330000.0,3.0,2.25,2220,4060,1.0,1330,890,1993
326500.0,3.0,1.0,1060,7920,1.0,1060,0,1968
267000.0,3.0,1.0,1400,8100,1.5,1400,0,1944
362000.0,5.0,3.0,1810,3000,2.0,1810,0,1998
371500.0,3.0,1.0,1650,6400,1.0,980,670,1954
368000.0,4.0,1.75,2100,11942,1.0,1030,1070,1964
427550.0,2.0,1.0,880,4000,1.0,880,0,1940
235000.0,2.0,1.0,1020,7920,1.0,1020,0,1939
210000.0,3.0,2.0,960,9380,1.0,960,0,1949
485000.0,4.0,2.25,1900,7200,1.0,1370,530,1977
410000.0,3.0,2.0,1320,6000,1.5,1320,0,1920
435000.0,4.0,2.75,2230,9640,1.0,1320,910,1998
210000.0,3.0,1.0,1070,8179,1.0,1070,0,1949
1050000.0,4.0,2.75,2250,3433,1.5,1500,750,1927
613000.0,2.0,2.0,1170,1890,1.5,1170,0,1927
165000.0,1.0,1.0,850,8050,1.0,850,0,1906
430000.0,3.0,2.0,1550,6039,1.0,830,720,1942
1195000.0,4.0,3.5,3960,6654,2.0,2850,1110,2006
201500.0,3.0,1.0,1320,5000,1.5,1320,0,1912
325000.0,2.0,1.0,800,7260,1.0,800,0,1953
890000.0,4.0,2.75,2310,4020,3.0,2310,0,1979
970000.0,5.0,2.75,3500,5040,2.0,2950,550,1927
399500.0,4.0,1.75,1360,4840,1.5,1360,0,1928
1205000.0,4.0,3.5,3150,5500,2.0,3150,0,2014
325000.0,2.0,1.0,810,4080,1.0,810,0,1941
517000.0,2.0,1.5,1920,3408,1.0,960,960,1912
1675000.0,3.0,2.5,3490,8343,2.0,2150,1340,1939
2180000.0,6.0,2.75,4710,11000,2.0,3690,1020,1931
148000.0,2.0,1.0,630,4200,1.0,630,0,1930
950000.0,3.0,2.5,3480,7800,1.0,1750,1730,1941
405000.0,3.0,1.5,1010,7683,1.5,1010,0,1953
674600.0,4.0,2.5,2610,5140,2.0,2610,0,2006
320000.0,3.0,3.25,1450,1387,2.0,1180,270,2013
399950.0,5.0,2.75,1970,5400,1.0,1320,650,1986
550000.0,3.0,2.0,1970,4166,2.0,1270,700,1929
284000.0,4.0,1.75,1880,8800,1.0,1130,750,1960
737500.0,3.0,1.75,2320,10900,2.0,2320,0,1935
569000.0,3.0,3.25,2220,8227,1.5,1770,450,1929
700000.0,3.0,1.0,1410,7200,2.0,1410,0,1901
660000.0,3.0,1.0,1240,3500,1.0,1240,0,1927
226550.0,3.0,1.0,990,4440,1.0,990,0,1943
810000.0,4.0,1.75,2000,3988,1.0,1000,1000,1958
275000.0,3.0,1.0,1200,7800,1.0,1200,0,1954
679000.0,4.0,2.75,2100,4480,1.5,1780,320,1928
1465000.0,6.0,4.5,4230,6420,2.0,2360,1870,1916
410000.0,3.0,1.75,1660,6250,1.0,830,830,1980
1250000.0,4.0,2.5,2920,5500,1.0,2030,890,1957
425000.0,2.0,1.0,1320,8830,1.0,1020,300,1939
840000.0,3.0,2.0,2783,11177,2.0,2783,0,1910
599950.0,3.0,3.25,1830,1804,3.0,1830,0,2014
299880.0,3.0,2.5,1460,3044,2.0,1460,0,2000
680000.0,3.0,2.0,1780,5720,1.0,980,800,1925
335500.0,3.0,1.0,1370,6780,2.0,1370,0,1930
321500.0,1.0,1.0,730,1942,1.0,730,0,2008
599000.0,7.0,2.5,2580,5750,1.0,1880,700,1901
759000.0,4.0,1.75,2100,4750,1.0,1340,760,1975
300000.0,4.0,1.75,1820,5015,1.0,1190,630,1926
359000.0,3.0,1.5,1550,4980,1.0,1080,470,1978
550000.0,4.0,1.0,1440,3600,1.5,1440,0,1924
395000.0,2.0,1.0,930,6380,1.0,930,0,1940
380000.0,2.0,1.0,780,3910,1.0,780,0,1918
625000.0,4.0,1.0,1600,5500,1.5,1600,0,1946
900000.0,4.0,2.5,2230,4372,2.0,1540,690,1935
580000.0,3.0,1.75,1850,5100,1.0,1020,830,1909
749000.0,4.0,2.75,2700,6000,2.0,2100,600,1910
595000.0,4.0,3.25,3730,4560,2.0,2760,970,2013
487000.0,4.0,2.5,2540,5001,2.0,2540,0,2005
760000.0,4.0,2.25,3300,8365,3.0,3300,0,2014
374950.0,3.0,2.25,1390,1484,3.0,1390,0,2007
440000.0,3.0,1.5,1270,1413,3.0,1270,0,2007
775000.0,6.0,2.75,2980,5000,1.5,2480,500,1916
725000.0,2.0,1.75,1950,2719,1.0,1010,940,1919
350000.0,4.0,1.0,1170,8147,1.5,1170,0,1959
639000.0,4.0,2.0,1840,5419,1.0,920,920,1942
800000.0,3.0,2.75,2220,4000,2.0,1700,520,1914
279000.0,2.0,1.0,670,6300,1.0,670,0,1942
880000.0,6.0,2.5,2640,3680,2.0,1760,880,1922
436110.0,3.0,2.5,1770,1235,3.0,1600,170,2007
620000.0,3.0,1.5,1620,6630,1.0,1280,340,1954
254000.0,4.0,2.0,1510,4235,1.0,1510,0,1955
1234582.0,5.0,3.25,3240,6551,1.5,2500,740,1939
205425.0,2.0,1.75,880,6780,1.0,880,0,1945
505000.0,3.0,2.25,1670,1596,2.0,1220,450,2002
670000.0,3.0,2.5,2700,1438,2.0,1280,1420,2003
202000.0,1.0,1.0,590,833,1.0,590,0,1926
291000.0,3.0,1.75,1560,9788,1.0,1560,0,1964
744312.5,4.0,2.5,2800,5900,1.0,1660,1140,1963
439333.333333,3.0,3.5,3020,4082,2.0,2080,940,1954
330000.0,3.0,3.0,1680,1570,3.0,1680,0,2014
554250.0,3.0,2.5,1490,1709,3.0,1490,0,2004
300000.0,3.0,2.0,1510,7066,1.0,1230,280,1973
274750.0,4.0,2.5,1840,1562,2.0,1400,440,2004
148612.5,3.0,1.0,1040,5000,1.0,1040,0,1959
326428.571429,3.0,1.0,1250,4800,1.0,1250,0,1951
135333.333333,4.0,1.0,1530,7200,1.5,1400,130,1948
577437.5,4.0,2.5,2110,3750,2.0,2110,0,2000
440825.0,3.0,1.75,2150,4333,1.0,1200,950,1956
195000.0,5.0,3.75,5340,10655,2.5,3740,1600,1912
193000.0,3.0,1.5,2200,5000,1.5,2200,0,1932
266066.666667,4.0,1.0,1310,5200,1.5,1160,150,1945
450385.714286,3.0,2.0,1300,3731,1.0,900,400,1993
308830.769231,2.0,1.0,810,4800,1.0,810,0,1919
287919.782609,2.0,1.0,1090,5000,1.0,730,360,1942
247875.0,2.0,1.0,1000,4776,1.0,1000,0,1942
173666.666667,4.0,1.0,1290,5000,1.5,1290,0,1957
790000.0,4.0,2.5,2310,5100,2.0,2310,0,2013
678333.333333,3.0,2.5,1840,3035,1.0,920,920,1926
535000.0,4.0,2.25,2290,5350,2.0,2120,170,1958
596165.428571,4.0,2.0,2580,6000,1.0,1300,1280,1950
148612.5,3.0,1.0,1040,6860,2.0,1040,0,1942
535000.0,4.0,2.25,2980,8051,1.5,2020,960,1935
440825.0,3.0,1.75,1980,6250,1.0,1090,890,1910
2560498.33333,3.0,2.5,1710,1664,2.0,1300,410,2003
423050.925926,2.0,1.0,890,4590,1.0,890,0,1923
458663.888889,2.0,1.0,1470,7137,1.0,1020,450,1941
135333.333333,4.0,1.0,1200,7200,1.5,1200,0,1944
790000.0,4.0,3.25,2420,4000,1.5,1870,550,1911
435500.0,3.0,3.5,1240,1666,2.0,1000,240,2008
738190.857143,3.0,2.5,2300,3060,1.5,1510,790,1930
300000.0,3.0,2.0,2020,8555,1.0,1220,800,1957
1036200.0,4.0,3.25,2500,5801,1.5,1960,540,1926
163785.714286,2.0,1.0,760,5500,1.5,760,0,1947
351250.0,4.0,1.75,1580,5340,1.0,1130,450,1947
233166.666667,3.0,2.0,1570,7000,2.0,1050,520,1971
331366.666667,3.0,2.5,1270,2509,2.0,1270,0,2004
337945.75,2.0,1.0,940,9839,1.0,940,0,1910
323833.333333,4.0,1.0,1940,5753,1.5,1940,0,1947
309000.0,3.0,2.5,1800,2700,2.0,1800,0,2011
994500.0,4.0,2.25,2870,6280,1.5,1980,890,1905
379509.166667,2.0,1.0,880,6413,1.0,880,0,1950
362750.0,2.0,1.75,1240,3000,1.5,1240,0,1906
198995.0,3.0,1.0,1410,8053,1.0,1410,0,1951
190368.75,2.0,1.0,1120,5650,1.0,1120,0,1944
360500.0,3.0,2.5,1150,887,3.0,1150,0,2007
258125.0,2.0,1.0,930,7740,1.0,930,0,1924
167500.0,1.0,1.0,690,1950,1.0,690,0,1928
471500.0,4.0,3.0,2370,3672,1.5,1650,720,1916
464600.0,2.0,1.0,840,3400,1.0,840,0,1924
433111.111111,3.0,2.25,1370,1524,3.0,1370,0,2005
558653.846154,3.0,2.5,1530,3210,1.5,1010,520,1928
318000.0,2.0,1.75,1530,3503,1.0,830,700,1916
550607.142857,4.0,2.0,1660,4800,1.5,1660,0,1922
1288333.33333,6.0,4.5,3830,4800,3.0,3050,780,1919
584000.0,3.0,1.75,1490,1036,2.0,1090,400,2008
245000.0,3.0,3.0,2470,7410,2.0,1860,610,1977
287919.782609,2.0,1.0,870,4600,1.0,870,0,1942
454790.0,2.0,1.75,1990,4000,1.0,1090,900,1952
473200.0,3.0,1.5,1740,4200,1.5,1640,100,1920
406062.5,2.0,1.0,1290,4650,1.0,1290,0,1906
486895.0,3.0,1.0,1890,3330,1.5,1390,500,1901
396166.666667,3.0,1.75,1880,5752,1.0,940,940,1945
308166.666667,3.0,1.75,1510,6360,1.0,1510,0,1954
203400.0,4.0,2.0,2090,6630,1.0,1070,1020,1974
